אֵב	ev
אָבֹב	avov
אֲבַגְתָא	avagta
אָבַד	avad
אָבֵד	aved
אִבֵּד	ibed
אֲבֵדָה	aveda
אֲבַדּוֹן	avadon
אָבְדָּן	ovdan
אָבְדָּנִי	ovdani
אָבָה	ava
אִבּוּד	ibud
אֵבוּז	evuz
אֲבוֹי	avoy
אִבּוּל	ibul
אֶבוֹלוּצְיָה	evolutzya
אִבּוּלִים	ibulim
אֵבוּס	evus
אָבוֹת	avot
אֲבוֹתֵיכֶם	avotechem
אַבְזָקָא	avzaka
אַבְזָר	avzar
אִבְזֵר	ivzer
אֻבְזַר	uvzar
אִבְחָה	ivkha
אִבְחוּן	ivkhun
אִבְחֵן	ivkhen
אֻבְחַן	uvkhan
אֶבְטַח	evtakh
אֻבְטַח	uvtakh
אַב־טִיפּוּס	av tipus
אָבִי	avi
אָבִי	avi
אָבִיב	aviv
אָבִּיגָ'אן	abidjan
אֲבִיהֶן	avihen
אֲבִי הָעֶזְרִי	avi haezri
אָבִיךְ	avich
אָבִיךָ	avicha
אַבִּיר	abir
אַבִּירִים	abirim
אֲבִישָׁלוֹם	avishalom
אֹבֶךְ	ovekh
אָבַל	aval
אֲבָל	aval
אֶבֶן	even
אַבְנֵט	avnet
אַבְנֵטִים	avnetim
אַבְנֵר	avner
אָבַס	abas
אַבְּסוּרְד	absurd
אֲבַעְבּוּעוֹת רוּחַ	avabuot ruakh
אָבָק	avak
אֶבֶק	evek
אַבְקָה	avka
אַבְקָן	avkan
אָבַר	avar
אֵבֶר	ever
אַבְרָהָם	avraham
אַבְרָם	avram
אַבְשָׁלוֹם	avshalom
אֲבֹתֵיכֶם	avotechem
אֲבֹתָם	avotam
אַגַּב	agav
אֲגֻדַּת	agudat
אֲגוּדָל	agudal
אֱגוֹז	egoz
אֱגוֹז אֲדָמָה	egoz adama
אֲגַם	agam
אַגַּן יַם תִּיכוֹן	agan yam tichon
אַגָּס	agas
אָגַר	agar
אֶגרוֹף	egrof
אִגְרוּף	igruf
אִגֶּרֶת חוֹב	igeret khov
אֵד	ed
אָדוֹן	adon
אַדִּיר	addir
אֲדִישׁוּת	adishut
אָדָם	adam
אָדֹם	adom
אֹדֶם	odem
אֲדָמָה	adama
אַדְמַת	admat
אֲדֹנָי	adonai
אֲדֹנָי	adonay
אֵדֶר	eder
אַדְּרַבָּא	adraba
אַדְּרַבָּה	adraba
אַדְרִיכָל	adrikhal
אָדַשׁ	adash
אָהַב	ahav
אַהֲבָה	ahava
אָהוּב	ahuv
אֶהְיֶה	ehye
אָהַל	ahal
אָהָל	ahal
אִהֵל	ihel
אַהֲרֹן	aharon
אוֹ	o
אוֹבָלִי	ovali
אוֹגוּסְט	ogust
אוֹהֵב	ohev
אוֹהָיוֹ	ohayo
אַוָּז	avaz
אוּזְבֶּקִית	uzbekit
אֲוָזוֹן	avazon
אוֹחַ	oakh
אוֹטוֹבּוּסִים	otobusim
אוּטוֹפְּיָה	utopiya
אוֹיֵב	oyev
אוֹי וַאֲבוֹי	oy vaavoy
אֲוִירוֹן	aviron
אוּלַי	ulai
אוֹלִיגַרְךְ	oligarkh
אוֹלִימְפִּי	olimpi
אוֹמֵן	omen
אוֹמֵר	omer
אוֹמְרִים	omrim
אוֹן	on
אוּנִיבֶרְסִיטָה	universita
אוֹנֵנה	onena
אוננים	unanim
אוֹסְטְרַלְיָה	ostralya
אוֹסְטְרָלִית	ostralit
אוֹפָה	ofa
אוֹפֶה	ofe
אוֹפּוֹזִיצְיָה	opozitsya
אוֹפַן	ofan
אוֹפַנּוֹעִים	ofanoim
אוֹפַנַּיִם	ofanayim
אוֹפּצִיָה	optzia
אוֹצָר	otsar
אוֹצֵר	otser
אוֹקְטוֹבֶּר	oktober
אוֹקֵי	okey
אוֹקְיָנוֹס הַקֶּרַח הַצְּפוֹנִי	okyanos hakerakh hatsfoni
אוּקְרָאִינָה	ukraina
אוֹר	or
אוֹרְגַּזְמָה	orgazma
אוֹרְגַּזְמוֹת	orgazmot
אוֹרְגָּנִיזְם	organizm
אוֹרְגָּנִיזַצְיָה	organizatzya
אוֹרָה	ora
אוּרִי	uri
אוּרַנְיוּם	uranyum
אוֹתָהּ	otah
אוֹתִי	oti
אוֹתִיּוֹת	otiyot
אוֹתֵת	otet
אָז	az
אֵזוֹר	ezor
אִזְכֵּר	izker
אֻזְכַּר	uzkar
אִזְמֵל	izmel
אֹזֶן	ozen
אֶזְרָח	ezrakh
אֶזְרָחוּת	ezrakhut
אֶזְרָחִי	ezrakhi
אָח	akh
אָח	akh
אַחַד עָשָׂר	akhad asar
אַחֲוָה	akhava
אָחוּז	akhuz
אֲחוּזִים	akhuzim
אִחוּר	ikhur
אָחוֹת	akhot
אָחַז	akhaz
אַחְזָקָה	akhzaka
אָחִי	akhi
אָחִיו	achiv
אֲחָיוֹת	akhayot
אַחִים	akhayim
אַחְיָנִית	akhyanit
אַחְלָמָה	akhlama
אַחַר	achar
אַחֵר	acher
אִחֵר	icher
אַחֲרוֹן	acharon
אַחֲרַי	akharay
אַחֲרֵי	akhare
אַחֲרָיוּת	akharayut
אַחֵרִים	akherim
אַחַר כָּךְ	akhar kakh
אַחַר־כָּךְ	akhar-kakh
אֲחֹתוֹ	achoto
אַחַת עֶשְׂרֵה	akhat esre
אַט אַט	at at
אָטוֹם	atom
אָטוֹמִי	atomi
אֵטִימוֹלוֹגְיָה	etimologya
אִטְלִיז	itliz
אֵי	e
אִי	i
אֵיבָר	eivar
אִידֵאָל	ideal
אִידִישָׁאִי	idisai
אַיָּה	aya
אַיָּה	aya
אַיֵּה	aye
אַיּוֹ	ayo
אִיּוּם	iyum
אִיזֶבֶל	izevel
אֵיזֶה	eize
אֵיזוֹ	eizo
אִיחוּד	ikhud
אִיטַלְקִי	italki
אִיִּים	iyim
אֵיךְ	eykh
אֵיכוּת	eikhut
אִיכְתִּיּוֹלוֹגְיָה	ikhtiyolohiya
אַיָּל	ayal
אַיִל	ayil
אֱיָל	eyal
אֱיָל	eyal
אֵילִים	elim
אִילָן	ilan
אִילָנוֹת	ilanot
אִילָנֵי	ilane
אֵילַת	eilat
אִיֵּם	iyem
אִימוּנוֹלוֹגְיָה	imunologia
אֵימָתַי	eimatay
אֵין	ein
אֵין דָּבָר הָעוֹמֵד בִּפְנֵי הָרָצוֹן	ein davar haomed bfnei haratzon
אֵין דִּין וְאֵין דַּיָּן	ein din vein dayan
אֵין דִּין וְאֵין דַּיָּן	ein din vein dayan
אֵין מַצָּב	en matsav
אֵין עָשָׁן בְּלִי אֵשׁ	ein ashan bli esh
אִינְדּוֹנֶזְיָה	indonezya
אִינְדּוֹנֶזִית	indonezit
אֵינָהּ	einah
אִינְטֶלִיגֶנְטִי	inteligenti
אִינְטֶלִיגֶנְצְיָה	inteligentsya
אִינְטֶלִיגֶנְצְיָה מְלָאכוּתִית	inteligentsya melakhutit
אִינְטֶרְנֶט	internet
אֵינֵךְ	einekh
אֵינָם	einam
אֵינָן	einan
אֵינְסוֹף	einsof
אֵינְסוֹפִי	einsofi
אִינְפוֹרְמַצְיָה	informatsya
אִינְפְלַצְיָה	inflatsya
אֵיפֹה	eifo
אִירָאנִי	irani
אֵירוֹפָּה	eiropa
אִישּׁוּר	ishur
אִישִׁי	ishi
אִישִׁיּוּת	ishiyut
אִיֵּת	iyet
אֻיַּת	uyat
אַכַּד	akad
אִכְזֵב	ikhzev
אַכְזָבָה	akhzava
אִכֵּל	ikel
אֹכֶל	okhel
אֻכָּל	ukal
אָכְלָה	okhla
אֶל	el
אֶלָּא	ela
אָלְבּוּמִים	albumim
אַלְבָּנִי	albani
אַלְבַּנְיָה	albanya
אֱלֹהַי	elohai
אֱלֹהֵיך	eloheykh
אֱלֹהֵיכֵם	eloheykhem
אֱלֹהִים	elohim
אֲלֵהֶם	alehem
אֵלָו	elav
אֵלּוּ	elu
אִלּוּ	ilu
אֱלוֹהַּ	eloah
אֱלוּל	elul
אָלוּמִינְיוּם	aluminyum
אַלּוֹן	alon
אַלּוּנְקָה	alunka
אִלּוּץ	iluts
אַלְטֶע זַאכֶן	alte zakhen
אֱלֵי	ele
אֱלִי	eli
אֵלִי	eli
אֻלַי	ulay
אֵלֶיהָ	eleha
אֵלִיָּהוּ	eliyahu
אֲלֵיהֶם	alehem
אֲלֵיהֶן	alehen
אֵלָיו	elav
אֵלַיִךְ	elayikh
אֲלֵיכֶם	alechem
אֱלִיעֶזֶר	eliezer
אֱלִישֶׁבַע	elisheva
אֵלְכָה	elchaattention
אַלְכּוֹהוֹל	alkohol
אַלְכִּימְיָה	alkimia
אִלֵּם	ilem
אֻלָם	ulam
אַלְמָנָה	almana
אַלְמְנוּת	almnut
אֶלְעָד	elad
אָלֶ״ף	alef
אָלֶף	alef
אֶלֶף	elef
אִלֵּף	ilef
אֲלָפִים	alafim
אֶלֶקְטְרוֹן	elektron
אֱלֹקִים	elokim
אַל־רֵיחַ	al-reakh
אֵם	em
אִם	im
אֵם קְרִיאָה	em kria
אָמַד	amad
אַמָּה	ama
אַמְהָרִית	amharit
אֵמוּן	emun
אֱמוּנָה	emuna
אֱמוּנָתְךָ	emunatkha
אִמּוּץ	imuts
אָמוֹק	amok
אֲמִירָה	amira
אָמֵן	amen
אָמָּן	oman
אֻמַּן	uman
אֻמָּן	uman
אַמְנוֹן	amnon
אַמְנוּן	amnun
אָמָּנוּת	omanut
אֻמָּנוּת	umanut
אָמָּנוּת הַבָּמָה	omanut habama
אָמָּנוּת עַכְשָׁוִית	omanut akhshavit
אֱמֻנַת	emunat
אַמְסְטֶרְדָּם	amsterdam
אָ‏מְפֵּ‏רְסָ‏נְד	ampersand
אֶמְפַּתְיָה	empatia
אִמֵּץ	imets
אֹמֶץ	omets
אָמַר	amar
אֹמֶר	omer
אָמֶרִיקָאִי	amerikai
אֶמֶשׁ	emesh
אֱמֶת	emet
אֲמִתִּי	amiti
אָנָאלִי	anali
אַנְגְּלִית	anglit
אָנָּה	ana
אָנָה	ana
אָנוּ	anu
אָנוֹכִיּוּת	anochiyut
אָנוֹנִימִי	anonimi
אָנוּס	anus
אִנּוּס	inus
אֱנוֹשׁ	enosh
אֱנוֹשׁוּת	enoshut
אֱנוֹשִׁי	enosh
אֶנְזִים	enziym
אֲנַחְנוּ	anakhnu
אַנְטִיבְּיוֹטִיקָה	antibyotika
אַנְטְרֶקוֹט	antrekot
אֲנִי	ani
אֲנִי לֹא מְדַבֵּר אַנְגְּלִית	ani lo medaber anglit
אֲנִי לֹא מְדַבֵּר עִבְרִית	ani lo medaber ivrit
אֲנִי־עֶלְיוֹן	ani-elyon
אני צריך מפה	ani tsarikh mapa m
אני צריך מפה של העיר	ani tsarikh mapa shel hair m
אני צריכה מפה	ani tsrikha mapa f
אָנֹכִי	anochi
אָנֹכִי	anokhi
אָנָנָס	ananas
אַנָּס	anas
אֹנֶס	ones
אֶנְצִיקְלוֹפֶּדְיוֹת	entsiklopedyot
אַנְשֵׁי	anshe
אֲנָשִׁים	anashim
אָסָא	asa
אָסוֹן	ason
אָסוּר	asur
אִסּוּר	isur
אֶסְטוֹנִית	estonit
אַסְטְרוֹפִיזִיקָה	astrofiziqa
אַסְטְרָטֶגְיָה	astrategiya
אָסִימְפְּטוֹטָה	asimptota
אָסִיר	asir
אסלאם סוני	islam suni
אִסְלָאמִי	islami
אָסַף	asaf
אֹסֶף	osef
אֲסֵפָה	asefa
אַסְפִּירִין	aspirin
אָסֻרָה	asura
אֶסְתֵּר	ester
אֶעֱלֶה	eele
אַף	af
אַף־עַל־פִּי	af al pi
אָפָה	afa
אפ׳חד	afkhad
אֶפְחַד	efkhad
אַפִּיפְיוֹר	apifyor
אֲפִיקוֹמָן	afikoman
אֲפִלּוּ	afilu
אַפְּלִיקַצְיָה	aplikatsya
אָפְנָה	ofna
אֶפֶס	efes
אָפָּצִ׳י	apachi
אַפְּצִ׳י	apchi
אֹפֶק	ofek
אָפְקִי	ofki
אָפְקִיּוּת	ofkiyut
אֶפְרוֹחַ	efroakh
אַפְּרִיל	april
אֶפְרַיִם	efrayim
אַפְרִיקָה	afrika
אפרסקים	afarsekim
אֲפַרְפַּר	afarpar
אֶפְרָת	efrat
אִפְשֵׁר	ifsher
אָפַּתְיָה	apatia
אָץ	ats
אֶצְבַּע	etsba
אֶצְבַּעוֹת	etzbaot
אַצָּה	atsa
אָצִיל	atsil
אַצִּיל	atzil
אֵצֶל	etsel
אֲצֻלָּה	atsula
אֶצְלוֹ	etslo
אֶצְלְךָ	etzlkha
אָקָדֶמְיָה	akademya
אֶקוֹלוֹגִי	ekologi
אֶקוֹלוֹגְיָה	ekologya
אָקוֹרְד	akord
אַקְלִים	aklim
אַקְסֵסוֹרִי	aksesori
אַקְשִׁיב	akshiv
אַרְאֶה	are
אֵרָאֶה	erae
אָרַב	arav
אַרְבָּעָה	arbaa
אַרְבָּעִים	arbaim
אַרְגּוֹן	argon
אִרְגּוּן	irgun
אֲרוּחָה	arukha
אֲרוּחוֹת	aruchot
אָרוּס	arus
אֵרוּעַ	erua
אָרוּר	arur
אָרַז	araz
אֹרֶז	orez
אֹרַח	orakh
אֲרִי	ari
אֲרִיאֵל	ariel
אַרְיֵה	arye
אֲרָיוֹת	arayot
אָרִיקָה	arika
אָרֹךְ	arokh
אֹרֶךְ	orekh
אַרְכִיּוֹן	arkhion
אָרַכְנוֹפוֹבְּיָה	arakhnofobya
אֲרַם	aram
אַרְמוֹן	armon
אֲרַמִּי	arami
אֲרָמִית	aramit
אַרְמֶנְיָה	armenya
אַרְנָב	arnav
אַרְנָק	arnak
אֶרֶס	eres
אָרֻצָה	arutsa
אֶרְצֶה	ertse
אֲרָצוֹת	aratzot
אַרְצִי	artsi
אָרַר	arar
אִשָּׁה	isha
אִשָּׁה	ishah
אָשׁוּבָה	ashuva
אֶשְׁכּוֹלִיוֹת	eshkoliot
אֶשְׁכֵּיִים	eshkhayim
אֲשָׁכִים	ashakhim
אַשְׁכְּנַזִּי	ashkenazi
אַשְׁלְגָן	ashlegan
אֶשְׁלָחֲךָ	eshlachacha
אַשְׁלָיָה	ashlaya
אַשְׁמָה	ashma
אֶשְׁמַע	eshma
אֶשְׁמֹר	eshmor
אַשְׁמֹרֶת	ashmoret
אֲשֶׁר	asher
אָשֵׁר	asher
אִשֵּׁר	isher
אֻשַּׁר	ushar
אַשְׁרַאי	ashrai
אֲשֵׁרָה	ashera
אִשְׁרֵר	ishrer
אֵשֶׁת	eshet
אִשְׁתּוֹ	ishto
אשתיק	ashtik
אַתְּ	at
אֹת	ot
אֵת, אֶת־	et, et-
אַתָּה	ata
אִתָּהּ	itah
אָתוֹן	aton
אֲתוֹנוֹת	atonot
אֹתוֹת	otot
אִתִּי	iti
אֶתְכֶם	etchem
אִתְּכֶם	itchem
אִתְּכֶם	itkhem
אִתְּכֶן	itkhen
אִתָּם	itam
אַתֶּן	aten
אִתָּנוּ	itanu
בְּ־	b-
בֹּא	bo
בָּאָה	baa
בָּאָה	baa
בֹּאָהּ	boah
בָּאוּלִינְגּ	bauling
בָּאִים	baim
בָּא לְ־	ba le-
בֶּאֱמֶת	beemet
בָּאסָה	basa
בֵּאֵר	beer
בְּאֵר	ber
בְּאֵר שֶׁבַע	ber sheva
בֻּבָּה	buba
בָּבֶל	bavel
בַּג	bag
בגד ים	beged yam
בְּגָדִים	bgadim
בָּגֶט	baget
בִּגְלַל	biglal
בִּגְלַל שֶׁ־	biglal she-
בג״ץ	b.g.ts.
בַּגְרוּת	bagrut
בַּד	bad
בָּדָד	badad
בִּדֵּחַ	bideakh
בַּדְחָן	badkhan
בְּדִיּוּק	bdiyuk
בְּדִיחָה	bdikha
בְּדִיחוֹת	bdichot
בְּדִיעֲבַד	bediavad
בְּדִיקָה	bdika
בְּדָל	bdal
בִּדֵּל	bidel
בְּדֹלַח	bdolakh
בַּדְלָנוּת	badlanut
בָּדַק	badak
בָּהָאִי	bahai
‎‎בָּהֶם	bahem
בְּהֵמָה	behema
בְּהֵמוֹת	behemot
בְּהַצְלָחָה	bhatzlakha
בְּהָקִיץ	bhaqits
בּוֹ	bo
בּוֹא	bo
בּוֹדַד	bodad
בּוֹדֵד	boded
בּוֹלֵט	bolet
בּוּל עֵץ	bul ets
בוֹנוּס	bonus
בּוֹסְפּוֹרוּס	bosporus
בּוּעָה	bua
בּוֹקֵר	boker
בוּר	bur
בָּז	baz
בִּזְבֵּז	bizbez
בִּזְהִירוּת	bizhirut
בִּזְכוּת	bizkhut
בַּזֶּלֶת	bazelet
בָּחוּר	bakhur
בַּחוּרָה	bakhura
בְּחִירָה	bkhira
בְּחִירוֹת	bkhirot
בִּטֵּא	bite
בֻּטָּא	buta
בִּטּוּחַ	bituakh
בִּטּוּי	bitui
בָּטַח	batakh
בֶּטַח	betakh
בִּטָּחוֹן עַצְמִי	bitakhon atzmi
בִּטְחוֹנִי	bitkhoni
בָּטָטָה	batata
בָּטֵל	batel
בֻּטַּל	butal
בֹּטֶן	boten
בִּי	bi
בֵּיְגֶּל	beigel
בֵּיְגָּלֶה	beigale
בִּיג מֶק	big mek
בִּידוּד	bidud
בִּיוֹ־	biyo- , bio-
ביוטכנולוגיות	biotekhnologyot
ביוטכנולוגית	biotekhnologyat
בִּיוֹלוֹגְיָה	biologia
בִּיּוֹמֶטְרִיָּה	biyometriya
בִּיּוֹמַסָּה	biyomasa
בִּימָה	bima
בִּינָה מְלָאכוּתִית	bina melakhutit
בִּינַת	binat
בֵּינְתַיִם	beintayim, beinatayim
בֵּיצָה	betza
בֵּיצֵפָר	beitsefer
בִּירָה	bira
בַּיְשָׁן	bayshan
בֵּית	beyt
בֵּיתָא	beta
בֵּית דִּין	bet din
בַּיְתָה	bayta
בֵּיתָה	beta
בֵּיתָהּ	betah
בֵּית־חוֹלִים	beit-kholim
בֵּית חֲרֹשֶׁת	beit-kharoshet
בית מלון	beit malon
בֵּית סֵפֶר	bet sefer
בֵּית־קָפֶה	beit-kafe
בֵּית שֶׁמֶשׁ	beyt shemesh
בִּכָּה	bika
בְּכוֹר	bkhor
בֶּכִי	bekhi
בַּכְיָן	bakhyan
בְּכָל זֹאת	bkhol zot
בִּכְלָל	bikhlal
בֶּכֶר	bekher
בִּכֵּר	biker
בִּכְרִי	bichri
בְּכֹרֶךָ	bchorecha
בְּלֹא	blo
בִּלְבּוּל	bilbul
בִּלְבֵּל	bilbel
בָּלָגָן	balagan
בִּלָּה	bila
בִּלְהָה	bilha
בְּלוֹג	blog
בַּלּוּטָה	baluta
בִּלּוּי	biluy
בָּלוֹן	balon
בְּלִילָה	blila
בָּלַל	balal
בָּלַע	bala
בַּלְקָנִי	balkani
בַּלְשָׁן	balshan
בִּלְשָׁן	bilshan
בַּלְשָׁנוּת	balshanut
‎בָּם	bam
בַּמְבּוּק	bambuk
בָּמָה	bama
בְּמֶשֶׁךְ	bmeshekh
‎‎בָּן	ban
בָּן	ban
בֵּן	ben
בֶּן־זוֹנָה	ben-zona
בֶּן יִשְׂרָאֵל	ben yisrael
בֶּן־תַּרְבּוּת	ben tarbut
בַּנַּאי	banai
בָּנָאלִי	banali
בְּנִגּוּד לְ־	bnigud l-
בָּנָה	bana
בְּנָהּ	bnah
בָּנוּ	banu
בָּנוּ	banu
בְּנוֹ	bno
בְּנוּ	bnu
בָּנוֹת	banot
בֶּנזִין	benzin
בֶּנֶט	benet
בְּנֵי בְּרַק	bnei brak
בָּנָיו	banav
בְּנֵי יִשְׂרָאֵל	bne yisrael
בְּנֵיכֶם	bnechem
בָּנִים	banim
בָּנָנוֹת	bananot
בַּנְק	bank
בְּנֹתָיו	bnotav
בְּסֵדֶר גָּמוּר	bseder gamur
בָּסִיס	basis
בְּסִיסִי	bsisi
בְּעַד	bad
בָּעַט	baat
בְּעָיָתִי	baayati
בַּעַל	baal
בַּעַל	baal
בָּעַל	baal
בַּעַל זְבוּב	baal zvuv
בַּעַל חַיִּים	baal khayim
בְּעָלִים	balim
בַּעֲקִיפִין	baakifin
בְּעִקָּר	bikar
בָּעַר	baar
בִּעֵר	bier
בִּפְנִים	bifnim
בִּצָּה	bitza
בָּצֵק	batsek
בָּצֵק פָּרִיךְ	batsek parikh
בִּקְבֵּק	bikbek
בָּקָר	baqar
בִּקֵּר	biqqer
בֹּקֶר	boker
בְּקָרוֹב	bkarov
בְּקָרִים	bkarim
בִּקֹּרֶת	biqoret
בַּקְּרַת אַקְלִים	bakarat aklim
בִּקֵּשׁ	bikesh
בַּקְּשׁוֹת־	bakshot-
בַּקָּשׁוֹת	bkakashot
בַּקָּשַׁת־	bakashat
בִּקַּשְׁתָּ	bikashta
בַּר	bar
בָּר	bar
בָּרָא	bara
בֵּרֵא	bere
בֹּרֶג	boreg
בַּרְדְּלָס	bardlas
בַּרְוָז	barvaz
בַּרְוָזוֹן	barvazon
בְּרוּחַ הַזְּמַן	bruach hazman
בָּרוּךְ הַבָּא	barukh haba
בָּרוּר	barur
ברזים	brazim
בָּרַח	barach
בָּרִיא	bari
בְּרִיאָה	bria
בְּרִיאוּת	briut
בְּרִיאוּתִי	briuti
בְּרִיחַ	briakh
בֶּרִילְיוּם	berilyum
בְּרִית	brit
בְּרִיתוֹ	brito
בֵּרֵךְ	berekh  berakh
בֹּרַךְ	borakh
בֹּרַךְ	borakh
בְּרָכָה	brakha
בְּרֵכָה	brekha
בְּרָכָה אַחֲרוֹנָה	brakha akharona
בְּרָכָה רִאשׁוֹנָה	brakha rishona
בִּרְכּוֹן	birkon
בְּרָכוֹת	brakhot
בִּרְכַּת	birkat
בֶּרְלִין	berlin
בְּרַם	bram
בַּר מִינַן	bar minan
בַּרְמֶן	barmen
בָּרָק	barak
בְּרֶקְזִיט	brekzit
בְּרָקִים	brakim
בְּרֵרָה	brera
בֹּשׁ	bosh
בִּשְׁבִיל	bishvil
בִּשְׁבִילִי	bishvili
בְּשוּם אוֹפֶן	bshum ofen
בִּשֵּׁל	bishel
בֹּשֶׂם	bosem
בִּתּוֹ	bito
בְּתוֹךְ	btokh
בְּתוּלָה	betula
בְּתוּלוֹת	btulot
בְּתוּלַת	btulat
בָּתֵּי־כְּנֶסֶת	bate-kneset
בָּתִּים	batim
בַּת שֶׁבַע	bat sheva
גַּאֲוָה	gaava
גָּאַל	gaal
גְּאֻלָּה	gula
גֵּב	gev
גַּבַּאי	gabai
גָּבָה	gava
גָּבַהּ	gavah
ג־ב־הּ	g-b-h
גְּבוּל	gvul
גְּבוּלוֹת	gvulot
גִּבּוֹר	gibor
גְּבִינָה	gvina
גָּבִיעַ	gavia
גָּבַל	gaval
גְּבַל	gval
גִּבְעָה	giva
גִּבְעוֹל	givol
גִּבְעָתַיִם‎	givatayim
גָּבַר	gavar
גֶּבֶר	gever
גְּבַרְבַר	gvarvar
גַּבְרִי	gavri
גַּבְרִי	gavri
גַּבְרִיאֵל	gavriel, gabriel
גְּבָרִים	gvarim
גְּבִרְתִּי	gvirti
גְּבַרְתָּן	gvartan
גְּבַרְתֶּן	gvarten
גַּג	gag
גַּד	gad
גָּדוֹל	gadol
גְּדוֹת־	gdot-
גְּדִי	gdi
גָּדֹל	gadol
גֶּדֶם	gedem
גִּדְעוֹן	gidon
גְּדֵרָה	gdera
גֵּו	gev
גּוֹבָה	gova
גּוֹבֶה	gove
גּוֹי	goi
גְּוִיָּה	gviya
גּוֹלָן	golan
גּוֹלְף	golf
גּוֹנֵב	gonev
גּוֹנְבוֹת	gonvot
גּוֹנְבִים	gonvim
גּוֹנֶבֶת	gonevet
גּוֹסְפֶּל	gospel
גּוּף	guf
גּוּפָה	gufa
גּוּץ	guts
ג׳וּק	juk
גּוּר	gur
גּוּשׁ קָטִיף	gush katif
גִּזְבָּר	gizbar
גְּזוּזְטְרָה	gzuztra
גָּזַל	gazal
גֶּזַע	geza
גִּזְעָן	gizean
גָּזַר	gazar
גֶּזֶר	gezer
גִּזְרָה	gizra
גְּזֵרָה	gzera
גָּחוׂן	gakhon
גָּחוּן	gakhun
גֵּט	get
גִ׳יבְּרִישׁ	jibrish
גִּיגָבַּיְט	gigabayt
גֵּיהִנּוֹם	geihinom
גִיוֹרֶת	giyoret
גִּיחוֹן	gikhon
גִ׳ינְס	jins
גִּיֵּס	giyes
גֻּיַּס	guyas
גִּיר	gir
גִּיֵּר	giyer
גִּירִית	girit
גִ'ירָף	jiraf
גִ׳ירָפָה	jirafa
גִּישָׁה	gisha
גִּלְגּוּל	gilgul
גִּלְגּוּל	gilgul
גַּלְגַּל	galgal
גַּלְגַּל הַצָּלָה	galgal hatsala
גַּלְגַּל שִׁנַּיִם	galgal shinayim
גֻּלְגֹּלֶת	gulgolet
גָּלָה	gala
גֻּלָּה	gula
גִּלּוּי	giluy
גַּלָּח	galakh
גִּלֵּחַ	gileakh
גַּל חֹם	gal khom
גְּלִידָה	glida
גְּלִידוֹת	glidot
גְּלִידַת	glidat
גָּלִיל	galil
גָּלַל	galal
גֹּלֶם	golem
גַּלְעֵד	galed
גִּלְעָד	gilad
גַּל־קוֹל	gal-kol
גָּלַקְסִיָה	galaksia
גַּלְשַׁן שֶׁלֶג	galshan sheleg
גַּם	gam
גם כן	gam ken
גָּמָא	gama
גַמָּד	gamad
גִּמֵּד	gimed
גַּמָּדִי	gamadi
גַּמָּדִית	gamadit
גַּמֶּדֶת	gameded
גַּמָּל	gamal
גַּמֶּלֶת	gamelet
גָּמַר	gamar
גַּן	gan
גֶּן	gen
גַּן עֵדֶן	gan eden
גַּנָּב	ganav
גָּנַב	ganav
גָּנַבְנוּ	ganavnu
גְּנַבְתֶּם	ganavtem
גְּנַבְתֶּן	ganavten
גִּנָּה	gina
גְּנוֹסְטִי	gnosti
גְּנוֹסְטִיקָה	gnostiqa
גְּנוֹסִיס	gnosis
גְּנָזִים	gnazim
גֶּנִים	genim
גַּנָּן	ganan
גָּנַן	ganan
גַּנֶּנֶת	ganenet
גֶּנֶרָל	general
גַּסְטְרוֹנוֹמִי	gastronomi
גַּעְגּוּעַ	gagua
גֶּפֶן	gefen
גָּ׳קוּזִי	djakuzi
גֶ׳קְסוֹן	jekson
גָּר	gar
גֵּר	ger
גְּרָ״א	gra
גֶּרֶב	gerev
גַּרְבִּיוֹן	garbiyon
גַּרְבִּיוֹנִים	garbiyonim
גָּרָה	gara
גֵּרָה	gera
גֵּרָה	gera
גְּרוּזִינִית	gruzinit
גְּרוּטָאָה	grutaa
גָּרוֹן	garon
גְּרוֹנִי	groni
גַּרְזֶן	garzen
גְּרִיסָה	grisa
גֶּרְמָנִי	germani
גֶּרְמַנְיָה	germanya
גֶּרְמָנִית	germanit
גַּרְעִינֵי	garine
גַּרְעִינִי	garini
גְּרָף	graf
גֵּרֵשׁ	geiresh
גֵּרֵשׁ	geresh
גָּרַת	garat
גַּרְתְּ	gart
גַּרְתָּ	garta
גֵּרַת	gerat
גָּשׁוֹשׁ	gashosh
גֶּשֶׁם	geshem
גֻּשְׁפַּנְקָה	gushpanka
גֶּשֶׁר	gesher
גִּתִּית	gitit
דָּאַג	daag
דְּאָגָה	daga
דַּאֲגָן	daagan
דָּאָה	daa
דֹּאַר	doar
דֹּאַר אֶלֶקְטְרוֹנִי	doar elektroni
דֹּב	dov
דֻּבְדְּבָן	duvdvan
דִּבּוּר	dibur
דְּבוֹרָה	dvora
דִּבֵּר	diber
דֻּבַּר	dubar
דִּבְרֵי הַיָּמִים	divrei hayamim
דִּבְרֵי יְמֵי	divre yme
דְּבָרִים	dvarim
דְּבָרִים אֲחֵרִים	dvarim acherim
דְּבָרְךָ	dvarcha
דְּבַשׁ	dvash
דָּג	dag
דָּג	dag
דִּגְדֵּג	digdeg
דָּגִים	dagim
דֶּגֶל	degel
דֻּגְמָא	dugma
דֻּגְמָה	dugma
דַּד	dad
דּוֹ	do
דּוּ	du-
דואר זבל	doar-zevel
דּוֹגְמָה	dogma
דּוֹד	dod
דּוּד	dud
דּוֹדִים	dodim
דּוּדִים	dudim
דּוֹלָר	dolar
דוּן	dun
דַּוְקָא	davka
דוֹקטוֹר	doktor
דַּוָּר	davar
דּוֹרוֹן	doron
דּוֹרִית	dorit
דֹּחַן	dochan
דַּחַף	dakhaf
דָּחַף	dakhaf
דַּי	dai
דֵּי	dei
דִּיאֵטָה	dieta
דַּיָּג	dayag
דַּיָּה	daya
דִּיוֹ	diyo
דְּיוֹ	dyo
דִּיּוּן	diyun
דִּיּוּנִים	diyunim
דְּיוֹתָא	dyota
דְּיוֹתָה	dyota
דִּין	din
דִּיסְק קָשִׁיח	disk kashiakh
דִיפְּלוֹמָטִי	diplomati
דִּיפְּלוֹמַטְיָה	diplomatya
דִּירָה	dira
דֻּכָּא	duka
דְּלִי	dli
דְלעת	dlaat
דְּלֵקָה	dleika
דַּלֶּקֶת	daleket
דָּלֶ״ת	dalet
דָּלֶת	dalet
דֶּלְתָּא	delta
דֶּלְתּוֹת	deltot
דָּם	dam
דָּמָה	dama
דֶּמֶה	deme
דֵּמוֹקְרַטְיָה	demokratya
דְּמוּת	dmut
דָּמִים	damim
דִּמְיֵן	dimyen
דִּמֵּם	dimem
דִּמְעָה	dima
דָּן	dan
דֶּנְמַרְק	denmark
דֵּעָה	dea
דַּעַת	daat
דַּף	daf
דַּפְדְּפָן	dafdfan
דַּפִּים	dapim
דָּפַק	dafak
דֵּצֶמְבֶּר	detsember
דַּק	dak
דִּקְדּוּק	dikduk
דַּקָּה	daka
דַּקָּה	daka
דָּקֶל	daqel
דְקָלִים	dkalim
דַּקָּר	dakar
דָּקַר	dakar
דֶּקֶר	deker
דַּר	dar
דֹּר	dor
ד״ר	dr
דַּרְבּוּקָה	darbuka
דֶּרֶג	dereg
דָּרוֹם	darom
דְּרוֹר	dror
דֶּרֶךְ	derekh
דַּרְכּוֹן	darkon
דְּרָכִים	drachim
דַּרְקוֹן	darkon
דְּרָקוֹן	drakon
דָּרַשׁ	darash
דָּשָׁא	dasha
דָּת	dat
דָּתִי	dati
־ָה	-a
־ָהּ	-ah
הֲ־	ha-
הַ־	ha-
הֵ״א	he
הֵא	he
האו״ם	hau.m.
הָאוֹקְיָנוֹס הַדְרוֹמִי	haokyanos hadromi
הָאוֹקְיָנוֹס הַהׂדּי	haokyanos hahodi
הָאוֹקְיָנוֹס הַשָּׁקַט	haokyanos hashaket
הָאוֹר	haor
הָאַחֵרוֹת	haakherot
הָאִינְטֶרְנֶט	hainternet
הֵאִיץ	heits
הֵאִיר	heir
הַאִם	haim
הַאם	ham
הֶאֱמִין	heemin
הָאָרֶץ	haarets
הֶאֱשִׁים	heeshim
הַבָּא	haba
הֶבְדֵּל	hevdel
הֻבְדַּל	huvdal
הַבְדָּלָה	havdala
הִבְהִיר	hivhir
הִבִּיט	hibit
הֵבִיךְ	heivikh
הֵבִיס	hevis
הַבַּיְתָה	habayta
הֶבֶל	hevel
הִבְלִיעַ	hivlia
הֲבָנָה	havana
הֵבַנּוּ	hevanu, hevannu
הֲבָנוֹת	havanot
הֲבָנַת־	havanat-
הִבְרִיג	hivrig
הִבְרִיחַ	hiviakh
הַבְּרִית	habrit
הִבְשִׁיל	hivshil
הַגָּאוֹן מִוִּילְנָה	hagaon mivilna
הַגְבָּהָה	hagbaha
הִגְבִּיר	higbir
הֶגְבֵּל	hegbel
הַגְבָּלָה	hagbala
הֻגְבַּר	hugbar
הִגְדִּיל	higdil
הִגְדִּיר	higdir
הַגְדָּרָה	hagdara
הִגְזִים	higzim
הֵגִיב	hegiv
הִגִּיד	higid
הֲגִיָּה	hagiya
הִגִּיעַ	higia
הִגִּישׁ	higish
הַגָּלִיל	hagalil
הֵגֵן	hegen
הֻגְנַב	hugnav
הֲגַנָּה	hagana
הַגָּעָה	hagaa
הָגָר	hagar
הַגֵּר	hager
הַגָּשָׁה	hagasha
הִדְאִיג	hidig
הִדְגִּישׁ	hidgish
הַדְגָּמָה	hadgama
הֲדָדִי	hadadi
הֹדּוּ	hodu
הֲדַסָּה	hadasa
הָדָר	hadar
הִדְרִיךְ	hidrikh
הַדְרָכָה	hadrakha
הוּא	hu
הוּאַץ	huats
הוּאַר	huar
הוּבַל	huval
הוֹדָה	hoda
הוֹדִיעַ	hodia
הוֹדָעָה	hodaa
הוֹוֶה	hove
הוֹכִיחַ	hokhiakh
הוֹלִיד	holid
הוֹלֵךְ	holekh
הוֹלֵךְ־רֶגֶל	holekh-regel
הוֹלֶכֶת־רֶגֶל	holekhet-regel
הוֹלֵם	holem
הוֹלַנְד	holand
הִוֵּן	hiven
הוֹן	hon
הֻוַּן	huvan
הוֹסִיף	hosif
הוּסַף	husaf
הוֹעִיל	hoil
הוֹפִיעַ	hofia
הוֹפָעָה	hofaa
הוֹצֵא	hotse
הוֹצִיא	hotsi
הוֹצִיאֲךָ	hotsiacha
הוֹרָאָה	horaah
הוּרַד	hurad
הוֹרְדוֹס	hordus
הוֹרָה	hora
הוֹרֶה	hore
הוֹרִיד	horid
הוֹרִים	horim
הוֹרִישׁ	horish
הוֹרֵס	hores
הוֹשִׁיב	hoshiv
הוֹשִׁיעַ	hoshia
הוֹשֵׁעַ	hoshea
הוֹתִיר	hotir
הִזְדַּיֵּן	hizdayen
הִזְדַּמְּנוּת	hizdamnut
הִזְדַּעֲזֵעַ	hizdaazea
הִזְדַּעַזְעוּת	hizdaazut
הִזְדַּקֵּן	hizdaken
הִזְדַּקְּנוּת	hizdaknut
הִזְדָּרֵז	hizdarez
הַזֶּה	haze
הִזְהִיר	hizhir
הֵזִיז	heziz
הַזְמָנָה	hazmana
הִזְרִיק	hizrik
הֶחְבִּיא	hekhbi
הֶחָג	hechag
הֶחָג	hehag
הֶחְדִּיר	hekhdir
החופש הגדול	hakhofesh hagadol
הֶחְזִיק	hekhzik
הֶחְזִיר	hekhzir
הֵחִיל	hekhil
הֵחֵל	hekhel
הֻחְלַט	hukhlat
הֶחְלִיט	hekhlit
הֵחָלְשׁוּת	heikhalshut
הֶחְמִיץ	hekhmits
הֶחְשִׁיךְ	hekhshikh
הִטַּגֵּן	hitagen
הִטָּה	hita
הִטָּהֵר	hitaher
הִטַּנֵּף	hitanef
הַטְעָמָה	hatama
הִיא	hi
הָיָה	haya
הַיּוֹם	hayom
הָיִית	hayit
הָיִיתָ	hayita
הָיִיתִי	hayiti
הֵיכָן	hechan
הֵימִין	heimin
הִיסְטוֹרִי	histori
הִיסְטוֹרְיוֹגְרַפְיָה	historyografya
הַיַּרְדֵּ֔ן	hayyarden
הַיִּשּׁוּב	hayishuv
הִכָּה	hika
הֻכָּה	huka
הִכְחִישׁ	hikhkhish
הֲכִי	hakhi
הֵכִיל	hekhil
הֵכִין	hekhin
הִכִּישׁ	hikish
הֲכָנָה	hakhana
הִכְנִיס	hikhnis
הַכְנָסָה	hakhnasa
הַכְּנֶסֶת	hakneset
הִכְעִיס	hikhis
הֻכַּר	hukar
הִכְרִיז	hikhriz
הִכְשִׁיר	hikhshir
הֶכְשֵׁר	hekhsher
הִכְתִּיב	hikhtiv
הִכְתִּים	hikhtim
הִכְתִּיר	hikhtir
הִלְבִּישׁ	hilbish
הִלְהִיט	hilhit
הַלְוַאי	halvay
הִלְחִים	hilkhim
הֶלְיוּם	helyum
הֲלִיכָה	halikha
הַלִּיכּוּד	ha-likud
הֲלִיכוֹת	halichot
הֲלִיכַת	halichat
הָלַךְ	halakh
הָלַךְ לְעוֹלָמוֹ	halach lolamo
הֲלָכָה	halakha
הָלְכָה	halkha
הִלְכָתִי	hilkhati
הַלְלוּ	hallu
הַלְּלוּיָהּ	halluyah
הם	him
הַמֵּאָה	hamea
הָמָה	hama
הֵמָּה	hema
הָמוֹן	hamon
המחשבה	hamakhshava
הָמַחְשָׁבוֹת	hamakhshavot
הִמְלִיחַ	himliakh
הִמְלִיךְ	himlikh
הִמְלִיץ	himlits
הַמְלָצָה	hamlatsa
הַמֶּמְשָׁלָה	hamemshala
המערב	hamaarav
הִמְצִיא	himtsi
הַמָּקוֹם	hamakom
הַמִשְׂחָקִים הַאוֹלִימְפִּיִּים	hamiskhakim haolimpiyim
הִמְשִׁיךְ	himshikh
הֶמְשֵׁךְ יָבוֹא	hemshekh yavo
הֶמְשֵׁכִי	hemshekhi
הַמִּשְׁכָּן	hamishkan
הִמְתִּין	himtin
הִמְתִּינוּ	himtinu
הֵן	hen
הַנְדָּסָה	handasa
הֵנָּה	hena
הִנֵּה	hine
הִנְהִיג	hinhig
הֲנָחָה	hanakha
הִנְחָה	hinkha
הַנַּכְּבָּה	hanakba
הֵסֵב	hesev
הִסְבִּיר	hisbir
הִסְגִּיר	hisgir
הַסְּטוּדֶנְטִים	hastudentim
הִסְטוֹרְיָה	historia
הֵסִיר	hesir
הִסְכִּים	hiskim
הֶסְכֵּם	heskem
הֻסַּע	husa
הַסָּעָה	hasaa
הִסְפִּיק	hispik
הִסְתַּדְּרוּת	histadrut
הֲסָתָה	hasata
הִסְתַּיֵּם	histayem
הִסְתַּכֵּל	histakel
הִסְתָּעֵף	histaef
הָעֲבוֹדָה	haavoda
הֶעֱבִיר	heevir
הֶעֱדִיף	heedif
הֵעָדֵר	header
הָעוֹלָם	haolam
הָעִיר	hair
הֵעִיר	heir
הָעָם	haam
הָעֲמִידָה	amida
הָעֲרָבָה	haarava
הָפוּךְ	hafukh
הַפְחָתָה	hafkhata
הַפְטָרָה	haftara
הָפִיךְ	hafikh
הָפַך	hafakh
הֲפֵכָה	hafekha
הִפְלִיא	hifli
הִפְלִיץ	hiflits
הִפְסִיק	hifsik
הַפְסָקַת־אֵשׁ	hafsakat-esh
הִפְעִיל	hifil
הִפְקִיעַ	hifki
‎הַפָּר	hapar
הִפְרִיד	hifrid
הַפְרָעָה	hafraa
הֻפְשַׁט	hufshat
הִפְשִׁיט	hifshit
הִפְתִּיעַ	hiftia
הִצְבִּיעַ	hitzbia
הַצָּגָה	hatzaga
הִצְחִיק	hitskhik
הִצְטַבְרֵחַ	hitstavreakh
הִצְטַחֵק	hitstakhek
הִצְטַלֵּם	hitztalem
הִצְטַנֵּן	hitstanen
הִצִּיג	hitsig
הַצִּילֵנוּ	hatsilenu
הִצִּילָנוּ	hitsilanu
הִצִּיעַ	hitsia
הִצִּית	hitsit
הַצָּלָה	hatsala
הַצְלָחָה	hatzlakha
הִצְלִיחַ	hitzliakh
הַצָּעָה	hatsaa
הִקְבִּיל	hikbil
הִקְדִּישׁ	hikdish
הִקְהִיל	hikhil
הַקֹּטֶב	hakotev
הִקְטִין	hiktin
הֵקִים	heikim
הֵקִימוּ	heikimu
הֲקַלָּה	hakala
הֲקָלָה	hakala
הַקַּלָּה	hakala
הִקְלִיד	hiklid
הִקְלִיק	hiklik
הֲקָמָה	hakama
הֻקַּף	hukaf
הַקְפָּאָה	hakpaa
הֵקֵר	heker
‎הַר‎	har
הָרִאשׁוֹן	harishon
הַרְבֵּה	harbe
הִרְבָּה	hirba
הָרַג	harag
הֶרֶג	hereg
הָרֶה	hare
הַר הָאֱלֹהִים	har haelohim
הָרוּג	harug
הִרְוִיחַ	hirviakh
הֵרוֹן	heron
הִרְחִיב	hirkhiv
הִרְטִיב	hirtiv
הָרֵי	hare
הֲרֵי	harei
הָרִים	harim
הֵרִים	herim
הֲרִיסָה	harisa
הִרְכִּיב	hirkiv
הַר מְגִדּוֹ	har megiddo
הֶרֶס	heres
הֵרֵס	heres
הֹרַס	horas
הר סיני	har sinay
הִרְעִיל	hiril
הַרְצָאָה	hartsaa
הִרְצָה	hirtsa
הֶרְצֵלִיָּה	hertseliyya
הִרְשָׁה	hirsha
הִרְשִׁים	hirshim
הַר שֻׁלְחָן	har shulkhan
הָשֵׁב	hashev
הַשׁוֹאָה	ha-shoa
הִשְׁוָה	hishva
הֵשִׁיב	heshiv
הִשִּׂיג	hisig
הַשְׂכָּלָה	haskala
הִשְׁלִיךְ	hishlikh
הִשְׁלִים	hishlim
הִשְׁמִיד	hishmid
הִשְׁמִין	hishmin
הִשְׁמִיעַ	hishmia
הִשְׁפִּיל	hishpil
הַשְׁפָּעָה	hashpaa
הִשְׁקָה	hishka
הִשְׁקִיעַ	hishkia
הַשְׁקָעָה	hashkaa
הִשְׁתַּדֵּל	hishtadel
הִשְׁתּוֹחֵחַ	hishtokheakh
הִשְׁתַחְרֵר	hishtakhrer
הִשְׁתִּיל	histil
הִשְׁתִּין	hishtin
הִשְׁתַּכְנֵעַ	hishtachnea
הִשְׁתַּכֵּר	hishtaker
הִשְׁתַּלֵּחַ	hishtaleakh
הִשְׁתַּמֵּשׁ	hishtamesh
הִשְׁתַּפֵּר	hishtaper
הִתְאַבֵּד	hitabed
הִתְאַבֵּךְ	hitabekh
הִתְאַבֵּל	hitabel
הִתְאַדָּה	hitada
הִתְאַזֵּן	hitazen
הִתְבַּדֵּחַ	hitbadeakh
הִתְבּוֹדֵד	hitboded
הִתְבַּזְבֵּז	hitbazbez
הִתְבַּטֵּא	hitbate
הִתְבַּלְבֵּל	hitbalbel
הִתְבַּשֵּׁל	hitbashel
הִתְגַּבֵּר	hitgaber
הִתְגַּיֵּס	hitgayes
הִתְגַּיֵּר	hitgayer
הִתְגַּלְגֵּל	hitgalgel
הִתְגַּלָּה	hitgala
הִתְגַלֵּחַ	hitgaleach
הִתְגַּעֲגֵעַ	hitgaagea
הִתְוַדֵּעַ	hitvadea
הִתְוַכֵּחַ	hitvakeach
הִתְחַבֵּא	hitkhabe
הִתְחַבֵּר	hitkhaber
הִתְחַיְּבוּת	hitkhayvut
הִתְחִיל	hitkhil
הַתְחָלוֹת	hatkhalot
הִתְחַמֵּם	hitchamem
הִתִּיז	hitiz
הִתְיָעֲצוּת	hityaatsut
הִתְיַקֵּר	hityaker
הִתְיַקְּרוּת	hityakrut
הִתְיַשֵּׁב	hityashev
הִתְכַּוֵּן	hitkaven
הִתְכּוֹנֵן	hitkonen
הִתְכַּנֵּס	hitkanes
הִתְכַּנְּסוּת	hitkansut
הִתְלַבֵּשׁ	hitlabesh
הִתְלַהֲבוּת	hitlahavut
הִתְלוֹנֵן	hitlonen
הִתְמַהְמֵהַּ	hitmahmeah
הִתְמוֹדֵד	hitmoded
הִתְמַלֵּא	hitmale
הִתְמַצֵּא	hitmatse
הִתְנַבֵּא	hitnabe
הִתְנַגְּדוּת	hitnagdut
הִתְנַדֵּב	hitnadev
הִתְנֻדַּב	hitnudav
הִתְנַהֵג	hitnaheg
התנ״ך	hatanakh
הִתְנַכֵּר	hitnaker
הִתְנַסָּה	hitnasa
הִתְנַעֵר	hitnaer
הִתְנַפֵּל	hitnapel
הִתְנַצֵּל	hitnatsel
הִתְנַקֵּשׁ	hitnakesh
הִתְנַקְּשׁוּת	hitnaqshut
הִתְנַשֵּׁק	hitnashek
הִתְעוֹרֵר	hitorer
הִתְעַטֵּף	hitatef
הִתְעַלָּה	hitala
הִתְעַלֵּל	hitalel
הִתְעַלֵּף	hitalef
הִתְעָרֵב	hitarev
הִתְפּוֹצֵץ	hitpotsets
הִתְפַּטֵּר	hitpater
הִתְפֻּטַּר	hitputar
הִתְפַּלֵּא	hitpale
הִתְפַּלֵּל	hitpalel
הִתְפַסְפֵס	hitfasfes
הִתְפָּרֵד	hitpared
הִתְפַּרְסֵם	hitparsem
הִתְפַּשֵּׁט	hitpashet
הִתְפַּתְּחוּת	hitpatkhut
הִתְקִיף	hitkif
הִתְקַלֵּחַ	hitkaleach
הִתְקַלְקֵל	hitkalkel
הִתְקַנֵּא	hitkane
הֻתְקַף	hutkaf
הַתְקָפָה	hatkafa
הִתְקָרֵב	hitkarev
הִתְקָרֵחַ	hitkareakh
הִתְקָרְחוּת	hitkarkhut
הִתְרָאָה	hitraa
הִתְרַבָּה	hitraba
הִתְרַגֵּז	hitragez
הִתְרוֹקֵן	hitroken
הִתְרַחֵץ	hitrakhetz
הִתְרַחֵשׁ	hitrakhesh
הִתְרַפֵּא	hitrape
־וֹ	-o
וְ־	v-
וַאלְלָה	walla
וְאָמַר	vamar
וְאָמְרוּ	vamru
וְאָמַרְתָּ	vamarta
וּבָאת	uvat
וּבְכֵן	uvkhen
וַדָּאִי	vadai
וְדִבֶּר	vdiber
וְדִבַּרְתָּ	vdibarta
וְהוֹרֵיתִיךָ	vhoreticha
וְהָיוּ	vhayu
וְהִכֵּיתִי	vhiketi or vhiketi
וָו	vav
וואו	wau
ווֹלְקָנִי	volkani
וַיֹּאמֶר	vayomer
וַיָּבֵא	vayave
ויבאו	vayavo
וַיָּבֹאוּ	vayavou
וַיָּבוֹא	vayavo
וַיִּבֶן	vayiven
וַיְבַקֵּשׁ	vayvakesh
וַיְגַדֵּל	vaygadel
וַיִּגְדַּל	vayigdal
וַיְגָרְשׁוּם	vaygarshum
וַיֵּדַע	vayeda
וַיֹּדַע	vayoda
וַיּוֹשִׁעָן	vayoshian
וַיִּזְכֹּר	vayizkor
וַיַּחֲזֶק	vayachazek
וַיֶּחֱזַק	vayechezak
וַיִּטְמְנֵהוּ	vayitmnehu
וְיֶטְנָאם	vyetnam
וַיִּירָא	vayira
וַיַּךְ	vayach
וִילוֹן	vilon
וַיֵּלֶךְ	vayelech
וִילְנָה	vilna
וַיָּמָת	vayamot
וִינָה	vina
וַיִּנְהַג	vayinhag
וַיָּנָס	vayanos
וִיסְקִי	viski
וַיַּסְתֵּר	vayaster
וַיִּסָּתֵר	vayisater
וַיַּעַן	vayaan
וַיִּפֶן	vayifen
וְיָצָא	vyatsa
וִיקִי	viki
וִיקִימִלּוֹן	vikimilon
וִיקִיפֶּדְיוֹת	vikipedyot
וַיָּקָם	vayakom
וַיִּקְרָא	vayikra
וַיַּרְא	vayar
וַיָּשֶׁב	vayashev
וַיָּשָׁב	vayashov
וַיִּשְׁבְּ	vayishb
וַיִּשְׁמַע	vayishma
וַיְשַׁמַּע	vayshama
וַיִּשְׁמְעוּ	vayishmu
וַיַּשְׁקְ	vayashk
וַיִּשַּׁק	vayishak
וְכוּ׳	vkhu.
וִכּוּחַ	vikuakh
וֶנְטִילָטוֹר	ventilator
וֶנֶצְיָה	venetsya
וְנָתַתִּי	vnatati
וַעַד	vaad
וָפֶל	vafel
וֶרֶד	vered
וְרַדְרַד	vradrad
וְשִׁלַּחְתִּי	vshilachti
וְשָׂמַח	vsamach
־וֹת	-ot
וַתֹּאמַרְןָ	vatomarna
וַתְּבִאֵהוּ	vatviehu
וַתָּבֹאנָה	vatavona
וַתַּחְמֹל	vatachmol
וָתִיק	vatik
וַתֵּלֶד	vateled
וַתַּעַל	vataal
וַתִּקָּחֶהָ	vatikacheha
וַתִּקְרָא	vatikra
וַתֵּרֶא	vatere
וַתִּרְאֵהוּ	vatirehu
וַתֵּרֶד	vatered
וַתָּשֶׂם	vatasem
זְאֵב	zev
זָבָה	zava
זָבָה	zava
זְבוּבִים	zvuvim
זְבוּלוּן	zvulun
זְבֻל	zvul
זֶבְּרָה	zebra
זָבַת	zavat
זַגָּג	zagag
זִגֵּג	zigeg
זָהָב	zahav
זִהָה	ziha
זֹהָה	zoha
זִהוּי	zihui
זָהִיר	zahir
זְהִירוּת	zhirut
זִהֵם	zihem
זֹהַם	zoham
זֹהַר	zohar
זֹהַר הַצָּפוֹן	zohar hatsafon
זֹהַר קָטְבִּי	zohar kotbi
זוֹ	zo
זוּ	zu
זוֹאוֹלוֹגְיָה	zoologya
זוּג	zug
זוּז	zuz
זָוִית	zavit
זוֹל	zol
זוֹלֵג	zoleg
זוּלַת	zulat
זוֹנָה	zona
זוֹנֶה	zone
זַחַל	zakhal
זִיּוּן	ziyun
זִיּוּף	ziyuf
זַיָּן&lt;--	zayan
זַיִן	zayin
זִיֵּן	ziyen
זִיף	zif
זִיקּוּק	ziquq
ֵזִיקּוּקֵי דִּי-נוּר	zikukei di-nur
זִיקְפָּה	zikpa
זִירָה	zira
זֵיתָא	zeta
זֵיתִים	zetim
זַךְ	zakh
זָכָה	zakha
זְכוּכִית	zkhukhit
זָכוֹר	zachor
זָכוּר	zachur
זְכוֹר	zchor
זַכּוֹת	zakot
זַכּוּת	zakut
זָכַר	zachar
זָכָר	zachar
זֵכֶר	zecher
זִכָּרוֹן	zikaron
זִכְרִי	zichri
זִכְרֵי	zikhrei
זִכְרִי	zikhri
זְכָרִים	zcharim
ז״ל	z.l.
זִלְפָּה	zilpa
זָמִין	zamin
זָמַם	zamam
זְמָם	zmam
זְמַנִּים	zmanim
זָמַר	zamar
זֶמֶר	zemer
זִמֵּר	zimer
זַמָּרִים	zamarim
זַן	zan
זָן	zan
זָנָב	zanav
זְנָבוֹ	znavo
זַנְגְּבִיל	zangvil
זָנַח	zanakh
זַעֲזוּעַ	zaazua
זִעְזֵעַ	zizea
זֻעְזַע	zuza
זָעַם	zaam
זַעַם	zaam
זָעַף	zaaf
זָקוּק	zakuk
זָקַן	zaqan
זָקָן	zaqan
זָקֵן	zaqen
זָקַף	zakaf
זָר	zar
זֵר	zer
זַ׳רְגוֹן	zhargon
זָרַח	zarach
זֶרַח	zerakh
זְרִיקָה	zrika
זָרַע	zara
זָרַק	zarak
חַאג׳	khaj
חַאלַבּ	khalab
חַבַּ״דְנִיק	khabadnik
חִבּוּק	khibuk
חָבַט	khavat
חֲבִיתָה	khavita
חֲבָל	khaval
חֶבֶל	khevel
חַבָּלָה	khabala
חֲבָלָה	khavala
חֲבַצֶלֶת	havatzelet
חֶבֶק	khevek
חִבֵּק	khibek
חָבַר	khavar
חֶבֶר	khever
חִבֵּר	khiber
חֻבַּר	khubar
חֲבֵרָה	khavera
חֶבְרָה	khevra
חֶבְרֶה	khevre
חֶבְרוֹן	khevron
חֲבָרוֹת	havarot
חֲבֵרוּת	haverut
חַבְרוּתָא	habruta
חֲבֵר כְּנֶסֶת	khaver kneset
חַג׳	khaj
חָגַג	khagag
חַג הָאוּרִים	khag haurim
חֲגוֹרָה	khagora
חַגַּי	khaggay
חֲגִיגִי	khagigi
חַגִּים	chagim
חַד	had
חַד אֵיבָר	khad eivar
חַד גּוֹנִי	khad goni
חִדּוּשׁ	khidush
חֲדִירָה	khadira
חִדֶּקֶל	khidekel
חֶדֶר	kheder
חֲדֵרָה	khadera
חֲדָרִים	khadarim
חֲדַר־מִיּוּן	khadar-miyun
חָדָשׁ	khadash
חַדֵּשׁ	khadesh
חִדֵּשׁ	khidesh
חֲדָשׁוֹת	khadashot
חָדְשִׁי	chodshi
חֲדָשִׁים	khadashim
חֳדָשִׁים	khodashim
חוֹב	khov
חַוָּה	khava
חָוָה	khava
חוֹזֶה	choze
חִוֵּט	khivet
חוּט	khut
חוּ״ל	hu.l.
חוֹלֵל	kholel
חוֹנֵךְ	khonekh
חוֹף	khof
חוּץ	khutz
חוּץ מִ־	khuts mi-
חוּץ מִזֶה	khuts mize
חוֹקֵר	khoker
חוּר	ur
חִוֵּר	khiver
חוֹשֵׁב	khoshev
חָזָ״ל	khazal
חָזַק	chazak
חָזָק	chazak
חֹזֶק	khozek
חֲזָקָה	chazaka
חָזְקָה	chazka
חָזַר	chazar
חֲזָרָה	khazara
חַטָּא	khata
חָטָא	khata
חִטָּה	khita
חָטוּף	khatuf
חֲטַף סֶגּוֹל	khataf segol
חֲטַף פַּתָּח	khataf patakh
חֲטַף קָמָץ	khataf kamats
חֹטֶר	khoter, hoter
חַי	khay
חַיְדַּק	haydaq
חַיָּה	khaya
חִיּוּבִי	khiyuvi
חִיּוּךְ	khiyukh
חַיֵּיהֶם	chayehem
חַיִּים	hayim
חַיִּים	khayim
חַיִּים	khayim
חִיֵּךְ	khiyekh
חַיָּל	khayal
חַיִל	khayil
חֵיל אֲוִיר	kheil avir
חַיָּלִים	chayalim
חימם	khimem
חֵיפָה	kheifa
חֵיקוֹ	cheko
חֵי״ת	khet
חַיַּת מַחְמָד	khayat makhmad
חִכָּה	khika
חָכַם	khakham
חָכָם	khakham
חָכְמָה	khokhma
חָכְמִוֹת	khakhamut
חָכְמִים	khakhamim
חָל	khal
חָלַב	khalav
חֵלֶב	khelev
חַלְבָה	khalva
חֶלְבּוֹן	chelbon
חלב ישראל	chalav yisrael
חֶלֶד	kheled
חֹלֶד	kholed
חֻלְדָּה	hulda
חַלָּה	khala
חַלְוָה	khalva
חֲלוֹמוֹת	khalomot
חַלּוֹן	khalon
חִלּוּן	khilun
חַלְחֹלֶת	khalkholet
חַלְטוּרָה	khaltura
חֻלְיָה	hulya
חָלִיל	khalil
חָלִילָה	khalila
חֲלִיפָה	khalifa
חִלֵּל	hillel
חָלַם	khalam
חָלָס	halas
חָלַף	khalaf
חֻלְצָה	khultsa
חֵלֶק	khelek
חֵלֶק דִּבּוּר	khelek dibur
חֲלֵקֵי־	khalkei-
חֶלְקִי	khelki
חַם	kham
חֹם	khom
חֶמְאָה	khema
חָמַד	khamad
חֶמֶד	khemed
חַמָּה	khama
חֵמָה	khema
חָמוּד	khamud
חָמוּץ	khamutz
חֲמוֹר	khamor
חָמוּר	khamur
חָמוֹת	khamot
חַמִּין	khamin
חֲמִיצָה	chamitzah
חֲמִישִׁי	khamishi
חָמַל	khamal
חֶמְלָה	khemla
חָמָס	khamas
חֻמְצָה	khumtsa
חֻמְצָה	khumtza
חַמְצָן	khamtsan
חֲמֹר	chamor
חֶמֶר	chemer
חִמֵּר	chimer
חֹמֶר	chomer
חֹמֶר	khomer
חָמֵשׁ	khamesh
חֲמִשָּׁה עָשָׂר	khamisha asar
חֲמִשִּׁים	khamishim
חֲמֵשׁ עֶשְׂרֵה	khamesh esre
חֵן	chen
חָנָה	hana
חַנָּה	khana
חֲנוֹךְ	khanokh
חִנּוּךְ גּוּפָנִי	khinukh gufani
חִנּוּכֵי־	khinukhei-
חְנוּן	khnun
חְנוּנִית	khnunit
חַנְיוֹן	khanyon
חֲנֻיּוֹת	khanuyot
חָנַךְ	khanakh
חֻנַּךְ	khunakh
חֲנֻכָּה	hanukka
חֲנֻכָּה	khanuka
חֲנֻכִּיָּה	khanukiya
חָנַן	hanan
חָנָן	hanan
חָנַק	khanak
חַנְקָן	khankan
חָס	khas
חֶסֶד	khesed
חָסָה	khasa
חָסִיד	khasid
חֲסִידִי	khasidi
חָסַךְ	khasakh
חֹסֶר־אוֹנִים	khoser-onim
חִסָּרוֹן	khisaron
חִפָּה	khipa
חֻפָּה	khupa
חִפּוּשׂ	khipus
חֲפִיר	khafir
חָפַף	khafaf
חָפַץ	hafats
חֵפֶץ	hefets
חָפַר	khafar
חֲפַרְפֶּרֶת	hafarperet
חֻפַּשׁ	khupas
חֻפַּשׁ	khupash
חֻפְשָׁה	khufsha
חָפְשִׁית	khofshit
חֲצָאִית	khatsait
חֲצוֹת	khatsot
חֲצוֹת־הַלֵּיל	khatsot-haleyl
חֲצוֹת־הַלַּיְלָה	khatsot-halayla
חֵצִי	khetsi
חָצִיל	chatsil
חֻצְפָּה	khutspa
חִקָּה	khika
חֻקָּה	khuka
חַקְלָאוּת	khaklaut
חָקַק	khakak
חָקַר	khakar
חֵקֶר	kheker
חֵקֶר הַדָּגִים	kheker hadagim
חָרַב	kharav
חֶרֶב	kherev
חֲרֵדִיוֹת	kharediot
חֲרֵדִיּוּת	kharediut
חֲרֵדִים	kharedim
חֲרֵדִית	kharedit
חָרוּב	kharuv
חָרוּת	kharut
חֵרוּת	kherrut
חֵרוּת	kherut
חַרְטוֹם	khartom
חֵרֶם	herem
חֶרְמוֹן	khermon
חַרְמָן	kharman
חֶרֶס	kheres
חֲרֹסֶת	kharoset
חֹרֶף	khoref
חָרַץ	kharats
חֶרֶק	kherek
חָרַשׁ	kharash
חָרָשׁ	kharash
חֵרֵשׁ	kheresh
חָשׁ	khash
חַשָּׁב	khashav
חָשַׁב	khashav
ח־שׁ־ב	kh-sh-v
חֻשַּׁב	khushav
חֶשְׁבּוֹן	kheshbon
חֶשְׁבּוֹן אִינְפִינִיטֶסִימָלִי	kheshbon infinitesimali
חֶשְׁבּוֹן דִּיפֶרֶנְצְיָאלִי וְאִינְטֶגְרָלִי	kheshbon diferentsyali vintegrali
חָשׁוּב	khashuv
חָשׁוּד	khashud
חֶשְׁוָן	kheshvan
חֹשֶׁךְ	choshekh
חַשְׁמוֹנַאי	khashmonai
חַשְׁמַלִּי	khashmali
חַשְׁמַלִּית	khashmalit
חַשְׁמָן	khashman
חָשַׂף	khasaf
חֵשֶׁק	kheshek
חָתוּל	khatul
חֲתוּלָה	khatula
חֲתוּלִים	khatulim
חָתִיךְ	hatich
חֲתִיכָה	khatikha
חֲתִיכַת	hatichat
חֲתִימָה	khatima
חֲתָךְ	khatakh
חַתָּךְ	khatakh
חֲתַלְתּוּל	khataltul
חָתָן	khatan
חֹתֵן	khoten
חֹתְנוֹ	chotno
טִאְטֵא	tite
טֻאְטָא	tuta
טַבָּח	tabakh
טֶבַח	tevakh
טֶבַע	teva
טַבַּעַת	tabaat
טְבֶרְיָה	tverya
טִגֵּן	tigen
טֻגַּן	tugan
טֶהֱרָאן	teheran
טֶהֱרָאנִי	teherani
טוֹב	tov
טוּב	tuv
טוואי המשי	tevay hameshi
טוּנְגְּסְטֶן	tungsten
טַוָּס	tavas
טוֹפּוֹלוֹגְיָה	topologya
טוֹרְסוֹ	torso
טוּרְקְיָה	turkya
טָחַן	takhan
טִיּוּל	tiyul
טִיט	tit
טַיָּס	tayas
טִיסָה	tisa
טִיסוֹת	tisot
טִיפּוּס	tipus
טִירָה	tira
טֵי״ת	tet
טֵית	tet
טֶכְנוֹלוֹגִי	tekhnologi
טֶכְנוֹלוֹגְיָה	tekhnologia
טַל	tal
טְלָאִים	tlaim
טֶלֶגְרָף	telegraf
טִלְגְּרֵף	tilgref
טֶלֶוִיזְיָה	televizya
טֶלֶוִיזְיוֹת	televizyot
טִלְטֵל	tiltel
טָלִין	talin
טַלִּיתוֹת	talitot
טֶלֶסְקוֹפּ	teleskop
טֵלֶסְקוֹפִּים	teleskopim
טִלְפֵּן	tilpen
טָמַן	taman
טֶנִיסַאי	tenisai
טֶנִיס שׁוּלְחָן	tenis shulkhan
טֶנִיס שֻׁלְחָן	tenis shulkhan
טֻנַּף	tunaf
טָס	tas
טֶסְט	test
טֶסְטוֹסְטֶרוֹן	testosteron
טָעוּת	taut
טָעִים	taim
טְעִימָה	tima
טַעַם	taam
טָעַם	taam
טַף	taf
טִפּוּל	tipul
טַפִּיל	tapil
טַפִּילִי	tapili
טֻפַּל	tupal
טֻפְּלוּ	tuplu
טֹפֶר	tofer
טֹפֶר	tofer
טִפֵּשׁ	tipesh
טֶקִילָה	tekila
טְרָגֶדְיָה	tragedya
טְרָגִי	tragi
טְרוֹל	trol
טָרִי	tari
טֵרִי	terry
טְרִי	tri-
טְרִיָּה	triya
טרייה	triya
טְרִיפּ	trip
טָרַף	taraf
טִרְפֵּד	tirped
יָאִיר	yair
יֵאָכֵל	yeachel
יֹאכַל	yochal
יַאלְלָה	yalla
יַאֲמִינוּ	yaaminu
יֵאָמַר	yeamar
יֹאמְרוּ	yomru
יְאֹר	yor
יָבוֹא	yavo
יְבַעֵר	yvaer
יָבֵשׁ	yavesh
י־ב־שׁ	y-b-sh
יַבֶּשֶׁת	yabeshet
יָד	yad
יְדַבֵּר	ydaber
יָדָה	yada
יָדָהּ	yadah
יָדוֹ	yado
יִדּוּעַ	yidua
יָדִיד	ydidei
יְדִידוּת	ydidut
יְדִידוּתִי	ydiduti
יָדֶיךָ	yadecha
יָדַיִם	yadayim
יָדִית	yadit
יְדָנִי	ydani
יָדַע	yada
יִדֵּעַ	yidea
יְהָב	yhav
יַהֲדוּת	yahadut
יַהֲדוּת חֲרֵדִית	yahadut kharedit
יַהֲדוּת קוֹנְסֶרְבָטִיבִית	yahadut konservativit
יְהוּדָה	yhuda
יְהוּדִי	yhudi
יְהוּדִים	yhudim
יְהוּדִית	yhudit
יהוה	yhvh
יְהוֹשֻׁעַ	yhoshua
יְהִי	yhi
יִהְיֶה	yihye
יָהִיר	yahir
יוֹבֵל	yovel
יוּבַל	yuval
יוֹ״ד	yod
יוֹד	yod
יוֹדֵעַ	yodea
יוּלִי	yuli
יוֹם־הֻלֶּדֶת	yom-huledet
יוֹם שִׁשִּׁי	yom shishi
יוֹמוּלֶדֶת	yomuledet
יוֹמָן	yoman
יָוָן	yavan
יוֹן	yon
יוֹנוֹסְפֶרָה	yonosfera
יוּנִי	yuni
יְוָנִי	yvani
יְוָנִית	yevanit
יְוָנִית	yvanit
יוֹנֵק	yonek
יוֹנַת	yonat
יוֹנָתָן	yonatan
יוֹסִי	yosi
יוֹסֵף	yosef
יוֹצֵא	yotse
יוֹצֵאת	yotset
יוֹרֶדֶת	yored
יוֹרָה	yora
יוֹרֶה	yore
יוּרָה	yura
יוֹשֵׁב	yoshev
יוֹשֶׁבֶת	yoshevet
־ִיּוֹת	-iyot
־ִיּוּת	-iyut
־ֻיּוֹת	-uyot
יוֹתֵר	yoter
יָזִיז	yaziz
יָזְמָה	yozma
יֶזַע	yeza
יִחֵד	yikhed
יְחֶזְקֵאל	yekhezkel
יְחִי	ykhi
יְחִידָה	yehida
יַחַס	yakhas
יְיָ	yy
יִידִישׁ	yidish
יַיִן	yayin
יֵינוֹת	yenot
יְכוֹלֶת	ykholet
יַכְטָה	yakhta
יָכֹל	yakhol
יָכְלָה	yachla
יָלַד	yalad
יַלְדָּה	yalda
יָלְדָה	yalda
יַלְדוּת	yaldut
יִלְדֵי	yilde
יְלָדִים	yladim
יַלֶּדְכֶן	yaledchen
יָלִיד	yalid
יְלִידֵי	ylidei
יַם סוּף	yam suf
יַמַּאי	yamai
יְמֵי הַבֵּינַיִם	ymei habeinayim
יַמִּים	yamim
יָמִים	yamim
יָמִים טוֹבִים	yamim tovim
יְמָמָה	yemama
יָנוּאָר	yanuar
יָנַק	yanak
יַנְקוּת	yanqut
יַנְשׁוּף	yanshuf
יִסֵּד	yised
יְסוֹד	yesod
יִסּוּד	yisud
יָעֶה	yae
יְעִילוּת	yilut
יָעֵל	yael
יָעֵל	yael
יִעֵל	yiel
יֹעַל	yoal
יַעֲנוּ	yaanu
יְעַנּוּ	yanu
יַעְנִי	yani
יַעַר	yaar
יַעֲשֶׂה	yaase
יֵּעָשֶׂה	yease
יְפֵהפֶה	yfefe
יֹפִי	yofi
יָפָּנִית	yapanit
יִפְרֶה	yifre
יִפְרֹץ	yifrots
יָצָא	yatsa
יֹצְאֵי	yotse
יִצְחַק	yitskhak
יָצַר	yatsar
יֵצֶר	yetser
יָקוּם	yakum
יְקוּם	yekum
יִקּוֹם	yikom
יָקָר	yakar
יִקָּרֵא	yikare
יִקְרָא	yikra
יָרֵא	yare
יֵרָאוּ	yerau
יַרְבֶּה	yarbe
יִרְבֶּה	yirbe
יְרוּשָׁלַיִם	yerushalayim
יְרוּשָׁלַ͏ִם	yrushalayim
יְרוּשָׁלֵם	yrushalem
יָרֵחַ	yareakh
יְרֵחִי	yrekhi
יֶרִי	yeri
יְרִיחוֹ	yrikho
יְרִיעָה	yeria
יִרְמְיָהוּ	yirmyahu
יָרַק	yaraq
יָרָק	yaraq
יָרֹק	yarok
יָרֹק	yaroq
יְרַקְרַק	yrakrak
יָרַשׁ	yarash
יְרֻשָּׁה	yrusha
יֵשׁ	yesh
יש;	yesh
יַשֵּׁב	yashev
יִשֵּׁב	yishev
י־שׁ־ב	y-sh-b
יִשּׁוּב	yishuv
יִשּׂוּם	yisum
יֵשׁוּעַ	yeshua
יְשִׁיבוֹת	yshivot
יְשִׁיבַת	yshivat
יָשִׂימוּ	yasimu
יש ל־ ג׳וק בראש	yesh l- juk ba-rosh
יִשְׁמָעֵאל	yishmael
יָשָׁן	yashan
יָשֵׁן	yashen
יָשָׁן נוֹשָׁן	yashan noshan
יְשַׁעֲיָהוּ	ysaayahu
יָשָׁר	yashar
יֹשֶׁר	yosher
יִשְׂרְאֵלִי	yisreli
יִשְׂרְאֵלִיּוֹת	yisreliyot
יִשְׂרְאֵלִים	yisrelim
יִשְׂרְאֵלִית	yisrelit
יִשְׁרְצוּ	yishrtsu
יִשָּׂשכָר	yisakhar
יָתֵד	yated
יִתֵּן	yiten
יֻתַּן	yutan
יֶתֶר	yeter
יִתְרוֹן	yitaron
כְּ־	k-
כְּאֵב	keev
כְּאֵב רֹאשׁ	keev rosh
כְּאִלּוּ	kilu
כָּאן	kan
כָּבֵד	kaved
כִּבֵּד	kibed
כָּבוֹד	kavod
כִּבְיָכוֹל	kivyakhol
כְּבִיסָה	kvisa
כִּבֵּס	kibes
כְּבָר	kvar
כָּבַשׁ	kavash
כֶּבֶשׂ	keves
כֶּבֶשׁ	kevesh
כַּד	kad
כְּדַאי	kdai
כַּדּוּרִים	kadurim
כַּדּוּר סַל	kadursal
כַּדּוּרְסַל	kadursal
כַּדּוּרְעָף	kaduraf
כַּדּוּר פּוֹרֵחַ	kadur poreakh
כְּדֵי	kde
כֹּה	ko
כֵּהֶה	kehe
כְּהֻנָּה	khuna
כּוֹבַע	kova
כּוֹבָעִים	kovaim
כּוּזָרִים	kuzarim
כּוֹכָב	kokhav
כּוֹכְבֵי לֶכֶת	kochve lechet
כּוֹכַב יָם	kokhav yam
כּוֹכָבִית	kokhavit
כּוֹכַב לֶכֶת	kokhav lekhet
כּוֹלֵל	kolel
כִּוֵּן	kiven
כּוֹנָן	konan
כּוֹנֵן	konen
כּוֹנָן קָשִׁיחַ	konan kashiakh
כּוֹס	kos
כּוֹסוֹת	kosot
כּוּסְכּוּס	kuskus
כּוֹר	kor
כּוּר	kur
כַּוֶּרֶת	kaveret
כּוֹרֵת עֵצִים	koret etsim
כּוּשִׁי	kushi
כּוֹתֵב	kotev
כָּזַב	kazav
כִּזֵּב	kizev
כֹּחַ	koach
כֹּחוֹת	kokhot
כְּחַלְחַל	kkhalkhal
כִּי	ki
כִּידוֹן	kidon
כידון רובה	kidon rovee
כִּיּוֹר	kiyor
כִימְיָה	khimya
כִּיֵּס	kiyes
כֵּיף	keif
כִּכֵב	kikhev
כָּכָה	kacha
כִּכָּר	kikar
כֹּל	kol
כָּלָא	kala
כֶּלֶא	kele
כֶּלֶב	kelev
כַּלְבָּה	kalba
כְּלָבוֹת	klavot
כֶּלֶב יָם	kelev-yam
כֶּלֶב כְּנַעֲנִי	kelev kenaani
כְּלַבְלָבִים	klavlavim
כֶּלֶב נָהָר	kelev nahar
כַּלֶּבֶת	kalevet
כַּלָּה	kala
כָּלָה	kala
כִּלָּה	kila
כָּלוּא	kalu
כְּלוּב	kluv
כְּלוּם	klum
כְּלִי	kli
כְּלִי־דָּם	kli-dam
כְּלִי זַיִן	kli zayin
כְּלִי טַיִס	kli tayis
כְּלִי נֶשֶׁק	kli nesheq
כְּלָל	klal
כל עוד	kol od
כַּמָּה	kama
כָּמַהּ	kamah
כָּמֵהַּ	kameah
כַּמּוּת	kamut
כְּמוֹת	kmot
כִּמְעַט	kimat
כֹּמֶר	komer
כֵּן	ken
כִּנּוֹר	kinor
כְּנִיסָה	knisa
כֶּנֶס	kenes
כְּנֵסִיָּה	knesia
כנסיית	knesiyat-
כְּנֶסֶת	kneset
כְּנַעֲנִי	knaani
כְּנַעֲנִית	knaanit
כָּנָף	kanaf
כּנר	khanar
כַּנִּרְאֶה	kanire
כִּנֶּרֶת	kineret
כֵּס	kes
כִּסֵּא	kise
כִּסּוּי	kisui
כִּסּוּפִים	kisufim
כַּסְכּוּסִים	kuskusim
כִּסְלֵו	kislev
כֻּסֶּמֶת	kusemet
כַּסְפּוֹמַט	kaspomat
כַּסְפִּית	kaspit
כַּסְתָּ״ח	kastah
כַּעַס	kaas
כַּף אַשְׁפָּה	kaf ashpa
כֵּף הַתִּקְוָה הַטּוֹבָה	kaf hatikva hatova
כָּפָה	kafa
כָּפָה	kafa past tense, kafa present tense
כַּפָּהּ	kapah
כִּפָּה	kipa
כָּפוּ	kafu
כָּפוּ	kafu
כְּפוּלָה	kfula
כְּפוּלִים	kfulim
כְּפוֹר	kfor
כִּפּוּר	kipur
כְּפִיר	kfir
כַּפִּית	kapit
כָּפַל	kafal
כֵּפֶל	kefel
כִּפְפַת אִגְרוּף	kiffat igruf
כְּפָר	kfar
כַּפָּרָה	kapara
כְּפַר סָבָא	kfar sava
כָּרָגִיל	ka-ragil
כָּרֶגַע	karega
כָּרָה	kara
כְּרוּב	kruv
כְּרוּכִית	krukhit
כַּרְטִיס	kartis
כַּרְטִיס אַשְׁרַאי	kartis ashrai
כְּרִיכָה	krikha
כְּרִיסְטְמַס	kristmas
כָּרִישׁ	karish
כָּרִית	karit
כַּרְמֶל	karmel
כָּרַע	kara
כָּרַת	karat
כְּשֶׁ־	kshe-
כִּשָּׁלוֹן	kishalon
כָּתַב	katav
כְּתָב	ktav
כְּתֻבָּה	ktuba
כָּתוּב	katuv
כְּתוּבָה	ktuva
כְּתוֹבֶת	ktovet
כְּתִיב	ktiv
כְּתִיבָה	ktiva
כֹּתֶל	kotel
כָּתֹם	katom
כְּתֹנֶת	ktonet
כָּתֵף	katef
כֶּתֶר	keter
כִּתֵּר	kiter
כִּתַּת יוֹרִים	kitat-yorim
לֹא	lo
לֹּא בָּרָא הַשָּׂטָן	lo bara hasatan
לֵאָה	lea
לֶאֶהוֹב	leehov
לְאַחַר	lakhar
לְאַט	lat
לְאֹם	lom
לֹא מִדֻּבְשְׁךָ וְלֹא מֵעֻקְצְךָ	lo miduvshkha vlo meuktskha
לְאֻמִּי	lumi
לְאֻמִּיּוּת	lumiyut
לֵאמֹר	lemor
לְאָן	lan
לֵב	lev
לֵבָב	levav
לִבֵּב	libev
לְבַד	lvad
לִבּוֹ	libo
לָבִיא	lavi
לְבִיָּא	lviya
לְבִיבָה	leviva
לַבְלַב	lavlav
לָבָן	lavan
לִבֵּן	liben
לֻבֵּן	luban
לְבַנְבַּן	lvanban
לַבָּנֶה	labane
לִבְנֶה	livne
לְבָנָה	lvana
לְבָנָה	lvana
לְבֵנָה	lvena
לְבָנוֹן	lvanon
לִבְנוֹת	livnot
לְבָנוֹת	lvanot
לֶבַנְטִינִי	levantini
לְבָנִים	lvanim
לִבְרוֹא	livro
לַבְּרִיאוּת	labriut
לְבָרֵךְ	lvarekh
לָבַשׁ	lavash
לְגַבֵּי	lgabei
לִגְלוֹת	liglot
לְגַמְרֵי	lgamre
לִגְנֹב	lignov
לָדִינוֹ	ladino
לָהּ	lah
לֶהָבָה	lehava
לְהִגָּמֵר	lhigamer
לַהַט	lahat
לָהַט	lahat
לָהֶם	lahem
לְהַפְרִיעַ	lhafria
לְהַצִּילוֹ	lhatsilo
לְהַצְלִיחַ	lhatsliach
לְהָרְגֵנִי	lhorgeni
לְהָרִיחַ	lhariakh
לְהַשְׁקוֹת	lhashkot
לְהִתְוַכֵּח	lhitvakeach
לְהִתְרָאוֹת	lhitraot
לוּ	lu
לוּב	luv
לוֹגוֹ	logo
לוֹד	lod
לוּחוֹת	lukhot
לוּחַ שָׁנָה	luakh shana
לֵוִי	levi
לְוִיִּם	lviyim
לַוְיָן	lavyan
לוֹנְדּוֹן	london
לְחִי	lekhi
לִחְיוֹת	likhyot
לְחִימָה	lekhima
לֶחֶם	lekhem
לַחְמָנִיָּה	lakhmaniya
לַחַן	lakhan
לַחֲנוֹק	lakhanok
לְחַפֵּשׂ	lkhapes
לָחַץ	lakhatz
'''לְטָאָה'''	ltaah
לִטֵּף	litef
לִי	li
לִיבִּידוֹ	libido
לְיַד־	lyad-
לְיָדָהּ	lyada
לֵיְזֶר	leizer
לִיטָא	lita
לִיטָאִי	litai
לַיְלָה	layla
לֵילוֹת	leilot
לִימוֹן	limon
לִימוֹנָדָה	limonada
לִינְק	link
לִיסְבּוֹן	lisbon
לֵית בְּרֵרָה	leyt berera
לִיתוֹגְרַפְיָה	litografia
לִיתְיוּם	lityum
לִכְבוֹד	likhvod
לִּכּוּד	likud
לִכּוּדְנִיק	likudnik
לִכְלוּךְ	likhlukh
לִכְלֵךְ	likhlekh
לְכָל שַׁבָּת יֵשׁ מוֹצָאֵי שַׁבָּת	lechol shabat yesh motzaei shabat
לִכְתּוֹב	likhtov
לְלֹא	llo
לָלֶכֶת	lalekhet
לְ־, לִ־, לַ־, לֶ־, לָ־, לֵ־, לוֹ־	l-, li-, la-, le-, la-, le-, lo-
לָם	lam
לָמַד	lamad
לָמֶד	lamed
לִמֵּד	limed
לַמְדָנִי	lamdani
לָמָּה זֶה	lama ze
לְמוּאֵל	lmuel
לִמּוּד	limud
לִמּוּדִים	limudim
לֶמוּר	lemur
לְמִידָה	lmida
לְמַעְלָה	lmala
לְמַעַן	lmaan
לְמַעַן הַשֵּׁם	lemaan hashem
לַמְרוֹת	lamrot
לָנוּ	lanu
לָנוּחַ	lanuakh
לִסְלוֹחַ	lisloakh
לַעֲבֹד	laavod
לְעוֹלָם	lolam
לַעֲזָאזֵל	laazazel
לָעַס	laas
לַעֲשׂוֹת	laasot
לְעִתִּים קְרוֹבוֹת	leitim krovot
לְפִי־	lfi-
לַפִּיד	lapid
לְפִיו	lfiv
לִפְעָמִים	lifamim
'''לֶפֶת'''	lefet
לֵק	leq
לָקָה	laka
לָקַח	lakakh
לְקַלְקֵל	lkalkel
לְקַנֵּא	lkane
לִקֵּק	likek
לֻקַּק	lukak
לֻקַּק	lukak
לִרְאוֹת	lirot
לָרוּץ	laruts
לִרְחֹץ	lirchots
לָרִיב	lariv
לָשֶׁבֶת	lashevet
לָשׁוּב	lashuv
לָשׁוֹן	lashon
לָשׁוֹן הָרַע	lashon hara
לְשׁוֹנוֹת	lshonot
לְשַׁחְרֵר	lshakhrer
לְשַׁלְּחוֹ	lshalcho
לִשְׁתּוֹת	lishtot
מַאֲבָק	maavak
מְאֹד	mod
מַאֲהָל	maahal
מְאַוְרֵר	mavrer
מְאוּשְׁכָּן	mushkan
מֵאוֹת	meot
מֵאָז	meaz
מְאֻחָד	mukhad
מְאֲחוֹרֵי	meakhorei
מְאֻחָר	mukhar
מַאי	may
מֵאַיִן	meayin
מֵאִיר	meir
מְאֻכְזָב	mukhzav
מַאֲכָל	maakhal
מְאֻכְלָס	mukhlas
מָאמִי	mami
מַאֲמָץ	maamats
מְאַמֵּץ	mamets
מַאֲמָר	maamar
מְאֻנָךְ	meunakh
מָאַס	maas
מַאֲפִיַּת	maafiyat
מְאֻשָּר	mushar
מְאֻשֶׁרֶת	musheret
מְאַת־	mat-
מָאתַיִם	matayim
מֵאִתָּנוּ	meiitanu
מְבֻגָּר	mevugar
מַבְדִּיל	mavdil
מַבּוּל	mabul
מְבוּשִׁים	mvushim
מַבָּט	mabat
מֵבִין	mevin
מְבֻיָּת	mvuyat
מְבֻלְבָּל	mvulbal
מִבְנֶה	mivne
מְבַקְשִׁים	mvakshim
מִבְרָשׁוֹת	mivrashot
מְבַשֵּׂר	mvaser
מָג	mag
מַגֶּבֶת	magevet
מֶגֶד	meged
מֻגְדָּל	mugdal
מִגְדָּל בָּבֶל	migdal bavel
מִגְדָּלָהּ	migdalah
מַגְהֵץ	maghetz
מְגֻוָּן	mguvan
מִגְוָן	migvan
מגידי שיעור	magidei-shiur
מַגָּל	magal
מְגִלָּה	mgila
מָגֵן	magen
מָגֵן אֲשָׁכִים	magen ashakhim
מָגֵן בֵּיצִים	magen beytsim
מַגְנֵט	magnet
מַגְנֵטִי	magneti
מַגְנֵטִיּוּת	magnetiut
מָגִנֵּי אֲשָׁכִים	maginei ashakhim
מִגְרָעָה	migraa
מַדָּד	madad
מָדַד	madad
מַדּוּעַ	madua
מְדוּרָה	medura
מַדְחֹם	madhom
מָדַי	maday
מִדֵּי	midey
מָדִינָה	madina
מְדִינָה	mdina
מְדִינוֹת	mdinot
מְדִינַת	mdinat
מַדָּע	mada
מַדְּעֵי הַרוּחַ	madei ha-ruach
מַדְעָן	madan
מַדְפֶּסֶת	madpeset
מַדְרִיד	madrid
מַדְרִיךְ	madrikh
מָה	ma
מְהַגֵּר	mhager
מָהִיר	mahir
מְהִירוֹת	mhirot
מְהִירוּת	mhirut
מַה לַּעֲזָאזֵל	ma laazazel
מְהַנְדֵּס	mhandes
מה עניין שמיטה אצל הר סיני	ma inyan shmita etzel har sinay
מַהֵר	maher
מִהַרְתֶּן	miharten
מַה שְּׁלוֹמֵךְ	ma shlomekh
מוּבָן	muvan
מוֹדִיעִין עִלִּית‎	modiin ilit
מוֹדֶם	modem
מוֹדָעָה	modaa
מוֹדַעַת אֵבֶל	modaat evel
מוֹדֶרְנִית	modernit
מוֹהֵל	mohel
מוּזִיקָה	muzika
מוּזָר	muzar
מוֹט	mot
מוּטָב	mutav
מוֹטֵט	motet
מוּכָן	mukhan
מוֹכֵר	mokher
מוֹל	mol
מוּל	mul
מוֹלֶדֶת	moledet
מוּם	mum
מוֹנוֹתֵאִיזְם	monoteizm
מוֹנִיּוֹת	moniyot
מוֹנִיטִין	monitin
מוֹנִית	monit
מוֹסְקְבָה	moskva
מוֹרֵד	mored
מוֹרִים	morim
מוּשְט	musht
מָוֶת	mavet
מָזַג	mazag
מִזֵּג	mizeg
מֻזַּג	muzag
מֶזֶג־אֲוִיר	mezeg-avir
מַזְגָן	mazgan
מְזֹהָם	mzoham
מִזּוּג	mizug
מִזְוָדָה	mizvada
מְזוּזָה	mzuza
מֵזַח	mezakh
מְזֻיָּף	mezuyaf
מַזְכִּיר	mazkir
מַזָּל	mazal
מַזְלֵג	mazleg
מְזַמֵּן	mzamen
מְזֻמָּן	mzuman
מְזַעֲזֵעַ	mzaazea
מְזֻעְזָע	mzuza
מִזְרָח	mizrakh
מַחְבּוֹא	makhbo
מַחְבֵּט	makhbet
מְחַבֵּל	mkhabel
מְחֻבָּר	mkhubar
מַחֲבַת	makhavat
מָחוֹג	makhog
מֶחֱוָה	mekheva
מְחוֹזוֹת	mkhozot
מְחוֹזִי	mkhozi
מַחֲזֶה	makhaze
מַחְזוֹר	makhzor
מַחֲזֶמֶר	makhazemer
מַחַט	makhat
מְחֻיָּב	mkhuyav
מְחִיקוֹן	mekhikon
מְחִירִים	mchirim
מַחְלָבָה	makhlava
מֻחְלָט	mukhlat
מַחְמָד	makhmad
מֻחַמַּד	mukhammad
מַחְמִיר	makhmir
מחנה ריכוז	mahane-rikkuz
מַחֲנַיִם	makhanayim
מַחְסָן	makhsan
מֹחַ עֶצֶם	moah etzem
מְחֻפָּשׁ	mkhupash
מַחַק	makhak
מָחַק	makhak
מֶחְקָר	mekhkar
מֶחְקָרִים	mechkarim
מָחָר	makhar
מָחָר כָּךְ	makhar kakh
מָחֳרָתַיִם	mokhoratayim
מַחְשֵׁב	machshev
מַחְשָׁבָה	makhshava
מַחְשְׁבוֹן	makhshvon
מַחֲשָׁבוֹת	makhshavot
מְחֻתָּן	mkhutan
מַחְתֶּרֶת	makhteret
מִטְבָּחִים	mitbakhim
מַטְבֵּעַ חוּץ	matbea khuts
מַטְבֵּעַ לָשׁוֹן	matbea lashon
מטֻגָּן	mtugan
מַטָּה	mata
מַטֶּה	mate
מִטָּה	mita
מָטוֹס	matos
מַטָּלָה	matala
מְטַמְטֵם	mtamtem
מִטְמָנָה	mitmana
מִטְעָן	mitan
מְטֻפָּל	mtupal
מָטַר	matar
מָטָר	matar
מַטָּרָה	matara
מִטְרִיָּה	mitriya
מֵי	me
מִי	mi
מְיֻבָּשׁ	myubash
מְיַבֵּשׁ כְּבִיסָה	meyabesh kvisa
מִיָּד	miyad
מִיָּדִי	miyadi
מִיהוּ	mihu
מָיוֹנֶז	mayonez
מֵיזָם	meizam
מְיֻזָּע	myuza
מְיֻחָד	myuchad
מְיֻחָד	myukhad
מִיכָאֵל	mikhael
מִיכָה	mikha
מִיכָיָה	mikayah
מֵיכָל	meikhal
מִיכַל	mikhal
מֵילָא	meila
מִילָה	mila
מִילְיַארְד	miliard
מִילָנוֹ	milano
מַיִם	mayim
מִימוּשׁ	mimush
מֵימֵי	meme
מֵימָן	meiman
מְיֻמָּן	meyuman
מִין	min
מִינִי	mini
מִינִיּוּת	miniyut
מִינְסְק	minsk
מִינֵרָלוֹגְיָה	mineralogya
מְיֻפֶּה־כֹּחַ	myupe-koakh
מִיץ	mits
מִיקְרוֹפוֹן	mikrofon
מִישִׁיגֶן	mishigen
מַכְאוֹב	makhov
מַכְאִיב	makhiv
מַכַּבִּי	makabi
מְכַבִּים	mchabim
מַכֶּה	make
מָכוֹן	makhon
מְכוֹנָה	mkhona
מְכוֹנִית	mkhonit
מכונת	mkhonat-
מְכוֹנַת גִּלּוּחַ	mekhonat giluakh
מְכוֹנַת כְּבִיסָה	mekhonat kvisa
מַכּוֹת	makot
מֵכִיל	mekhil
מְכִירָה	mkhira
מְכִירָה פֻּמְבִּית	mkhira pumbit
מַכְלֵב	makhlev
מִכְלוֹל	mikhlol
מִכְלָלָה	mikhlala
מֶכָנִיקָה	mekhanika
מֶכָנִיקָה קְלָסִית	mekhanika klasit
מֶכָנִיקַת	mekhanikat
מִכְנָסַיִם	mikhnasayim
מָכַר	makhar
מֻכָּר	mukar
מָכְרָה	machra
מִכְרָה	michra
מִכְרָהּ	michrah
מַכְשִׁיר	makhshir
מְכַשֵּׁף	mekhashef
מַכַּת	makat
מִכְתָּבִים	mikhtavim
מָלֵא	male
מֻלָּא	mula
מְלָאכָה	mlakha
מַלְאֲכֵי	malakhe
מַלְאָכִים	malachim
מַלְבֵּן	malben
מִלָּה	mila
מִלָּה	milla
מַלּוּחַ	maluakh
מָלוּחַ	maluakh
מְלוּכָה	mlukha
מִלּוֹנִים	milonim
מֶלַח	melakh
מָלַךְ	malakh
מֶלֶךְ‏	melekh
מַלְכֵי	malkhei
מַלְכִּי-צֶדֶק	malki-tsedek
מַלְכַּת	malkat
מַלְכַּת אֶסְתֵּר	malkat ester
מַלְמָד	malmad
מְלַמֵּד	mlamed
מִלְּעֵיל	milel
מְלָפְפוֹן יָם	mlaffon yam
מלצרים	miltzarim
מֶלְצַרִית	meltsarit
מִלְּרַע	milra
מֶם	mem
מָמוֹן	mamon
מִמּוּן	mimun
מַמְזֵר	mamzer
מֻמְחֶה	mumkhe
מַמְלֶכֶת	mamlekhet
מֻמְלָץ	mumlats
מַמְצִיא	mamtsi
מְמֻצָּע	mmutsa
מַמָּשׁ	mamash
מַמְשִׁיךְ	mamshikh
מֶמְשָׁלָה	memshala
מֶמְשָׁלוֹת	memshalot
ממשלת	memshelet
מָן	man
מִן	min
מַנְגּוֹ	mango
מַנְגִּינָה	mangina
מַנְדּוֹלִינָה	mandolina
מָנָה	mana
מָנֶה	mane
מִנְהָג	minhag
מַנְהִיג	manhig
מְנַהֵל	menahel
מְנַהֶלֶת	menahelet
מָנוֹעַ	manoa
מְנוֹרוֹת	mnorot
מַנְחֶה	manhe
מִנְחָה	minha
מְנַחֵם	mnachem
מִנַּיִן	minayin
מִנְיָן	minyan
מָנַע	mana
מְנֻקָּד	mnukad
מְנַשֶּׁה	menashe
מְנַתֵּחַ	menateakh
מְנֻתָּק	mnutak
מַס	mas
מְסִבָּה	msiba
מְסִבַּת עִתּוֹנָאִים	msibat-itonaim
מְסֻגָּל	msugal
מְסֻגָּלִים	msugalim
מִסְגֶּרֶת	misgeret
מִסְדְּרוֹן	misdron
מַסְטוּל	mastul
מַסְטִיק	mastik
מְסִילַּת בַּרְזֶל	msilat barzel
מִסִּים	misim
מַסֶּכֶת	masekhet
מַסְלוּל	maslul
מְסֻנְוָר	msunvar
מְסַנֶּנֶת	msanenet
מַסָּע	masa
מִסְעָדָוֹת	misadot
מִסְפָּר	mispar
מִסְפֵּר	misper
מְסַפֵּר	msaper
מֻסְפַּר	muspar
מִסְפָּרִי	mispari
מַס קְנִיָּה	mas kniya
מָסַר	masar
מֶסֶר	meser
מָסֹרֶת	masoret
מָסֹרֶת	masoret
מְסַרְתֵּן	msarten
מִסְתּוֹר	mistor
מַעֲבָר	maavar
מַעְבֹּרֶת	maboret
מְעֻבֶּרֶת	muberet
מַעְגָּל	maagal
מַעֲגָנָה	maagana
מַעֲדֵר	mader  maader
מעות חטים	maot itim
מְעִיל	mil
מְעִילָה	mila
מַעְיָן	maayan
מָעַל	maal
מֵעַל	meal
מַעֲלָה	maala
מַעֲלִית	maalit
מְעַנְיֵן	manyen
מְעֻנְיָן	munyan
מְעֻנָּן	munan
מַעֲצָר	maatsar
מַעֲקֶה	maake
מַעֲרָבוֹן	maaravon
מַעֲרוֹךְ	maarokh
מַעֲרִיב	maariv
מַעַרְכוֹן	maarkhon
מַעֲרֶכֶת&lt;--x--&gt;־&lt;--x--&gt;הַפְעָלָה	maarekhet-hafala
מַעֲרֶכֶת	maarekhet
מַעֲרֶכֶת סְגוּרָה	maarekhet sgura
מערכת שמש	maarekhet-shemesh
מַעַשׂ	maas
מַעֲשֶׂה	maase
מַעֲשֵׂר	maaser
מַפַּא״י	mapai
מַפַּאי	mapai
מַפּוּחַ	mapuakh
מַפּוֹת	mapot
מְפִיבֹשֶׁת	mpiboset
מַפִּית	mapit
מִפְלָגָה	miflaga
מַפְלִיא	mafli
מִפְלֶצֶת	mifletset
מִפְעָל	mifal
מְפַקֵּד	mfaked
מִפְקָדָה	mifkada
מְפֻרְסָם	mfursam
מִפְרָץ	mifrats
מִפְרָשׂ	mifras
מַפַּת	mapat
מַפְתֵּחַ	mafteakh
מָצָא	matsa
מַצַּב רוּחַ	matsav ruakh
מַצָּה	matsa
מְצַוָּה	mtsava
מְצַוֶּה	mtsave
מְצַוֶּה	mtsave
מְצֻוֶּה	mtsuve
מִצְווֹת	mitsvot
מַצּוֹת	matsot
מִצְוַת־	mitsvat-
מִצְוַת הַקְהֵל	mitsvat hak-hel
מִצְוֹתָיו	mitsvotav
מְצֻיָּן	mtzuyan
מְצִיצָה	metsitsa
מֻצְלָח	mutzlakh
מֻצְלַחַת	mutzlakhat
מַצְלִיחַ	matzliakh
מָצַץ	matsats
מֵצַר	meitsar
מִצְרִי	mitsri
מִצְרַיִם	mitsrayim
מִצְרַיְמָה	mitsrayma
מַקְבִּיל	makbil
מַקְדֵּחָה	makdekha
מֻקְדָּם	mukdam
מַקְהֵלָה	makhela
מִקְוֶה	mikve
מְקוֹמִי	mkomi
מָקוֹר	makor
מְקֻטָּל	mkutal, mquttal
מַקִּיף	makif
מַקֵּל	makel
מִקְלֶדֶת	mikledet
מִקְלַחַת	miklakhat
מַקְלֵט	maklet
מִקְלָט	miklat
מְקֻלְקָל	mkulkal
מִקֵּם	mikem
מֶקְסִיקוֹ	meksiko
מַקָּף	makaf
מֻקָּף	mukaf
מִקְרָא	mikra
מִקְרֶה	mikre
מְקָרֵר	mkarer
מֻקַּשׁ	mukash
מַר	mar
מַרְאָה	mara
מַרְאֶה	mare
מַרְאוֹת	marot
מַרְאִית עַיִן	marit ayin
מֶרֶד	mered
מָרְדֳּכַי‏‏‏	mordechay or mordechay
מָרָה	mara
מָרַח	marakh
מָרִיחוּאָנָה	marikhuana
מִרְיָם	miryam
מְרִיצָה	mritsa
מֶרְכָּב	merkav
מֶרְכָּבָה	merkava
מֶרְכָּזִי	merkazi
מַרְס	mars
מַרְפֵּא פֶּלֶא	marpe pele
מִרְפֶּסֶת	mirpeset
מֶרֶץ	merets
מֶרְץ	merts
מַרְצִיפָּן	martsipan
מָרָק	marak
מִרְשָׁם	mirsham
מְרֻשָּׁת	merushat
מַשְׁאֵבָה	masheva
מַשָּׂאִית	masait
מֻשָּׂג	musag
משגיח רוחני	mashgiakh rukhani
מְשֻׁגָּע	mshuga
מְשֻׁגָּע	mshuga
מַשֶּׁהוּ	mashehu
מִשְׁוָאָה	mishvaa
מַשּׂוֹא פָּנִים	maso panim
מָשׁוֹט	mashot
מְשׁוֹרֵר	meshorer
מָשׂוֹשׂ	masos
מָשַׁח	mashakh
מִשְׂחַק וִידֵאוֹ	miskhak video
מִשְׂחֲקֵי וִידֵאוֹ	miskhakei video
מִשְׂחָקִים	miskhaqim
מִשְׂחֲקֵי מַחְשֵׁב	miskhakei makhshev
מִשְׂחַק מַחְשֵׁב	miskhak makhshev
מָשִׁיחַ	mashiakh
מֶשֶׁךְ	meshekh
מִשְׁכָּן	mishkan
מְשַׁכְנֵעַ	mshakhnea
מַשְׂכֹּרֶת	maskoret
מָשָׁל	mashal
משלוחי מנות	mishlokhei-manot
מִשְׁלַח יָד	mishlakh yad
מַשְׁלִים	mashlim
מְשָׁלִים	mshalim
מֻשְׁלָם	mushlam
מִשְׁמֵעַ	mishmea
מִשְׁמֵשׁ	mishmesh
מְשַׁנֶּה	mshane
מְשֻׁנֶּה	mshune
מְשֻׁנּוֹת	mshunot
מִשְׁנָיוֹת	mishnayot
מְשֻׁנִּים	mshunim
מְשִׁסָּה	mshisa
מִשְׁפָּחָה	mishpakha
מִשְׁפָּחוֹת	mishpakhot
מִשְׁפַּחְתִּי	mishpakhti
מִשְׁפָּחְתִּי	mishpakhti
מִשְׁפָּט	mishpat
משפטים	mishpatim
מְשֻׁפָּע	mshupa
מַשְׁקֶה	mashke
מִשְׁקָל	mishkal
מִשְׁקָפַיִם	mishkafayim
מִשְׁתֶּה	mishte
מִשְׁתָּלָה	mishtala
מִשְׁתַּנֶּה	mishtane
מְשֻׁתָּף	mshutaf
מֵת	met
מֵת	met
מִתְאָר	mitar
מְתָאֵר	mtaer
מִתְגַּיֵּס	mitgayes
מֵתוּ	metu
מֶתוֹדָה	metoda
מְתַוֵּךְ	metavech
מָתוֹק	matok
מָתַי	matai
מַתִּי	mati
מַתִּירָנוּת	metiranut
מַתְכּוֹן	matkon
מְתֻכְנָן	mtukhnan
מָתֵמָטִיקָה	matematika
מָתֶמָטִיקָה	matematika
מַתָּנָה	matana
מֹתֶק	motek
מְתֻרְגָּם	mturgam
מְתֻרְגְּמָן	mturgman
נָא	na
נֶאֱבַד	neevad
נֶאֱגַר	neegar
נָאֶה	nae
נֶאֱהַב	neehav
נָאוָה	nava
נָאוֶה	nave
נֵאוֹן	neon
נָאוֹר	naor
נֶאֱכַל	neekhal
נֶאֱמַן	neeman
נֶאֱמָן	neeman
נֶאֱמָנוּת	neemanut
נָאַף	naaf
נֶאֱצָל	neetsal
נִבָּא	niba
נִבָּא	niba
נִבֵּא	nibe
נִבֵּא	nibe
נְבוֹ	nvo
נָבוֹן	navon
נִבְחַר	nivkhar
נִבְחָר	nivkhar
נָבִיא	navi
נָבַל	naval
נֵבֶל	nevel
נִבְרָא	nivra
נֶגֶב	negev
נַגָּד	nagad
נָגַהּ	nagah
נֹגַהּ	nogah
נִגּוּן	nigun
נִגְזֶרֶת	nigzeret
נִגֵּן	nigen
נָגַע	naga
נַגָּר	nagar
נֹגְשָׂיו	nogsav
נְדוּדִים	ndudim
נְדוּנְיָה	ndunya
נִדְחָה	nidkha
נָדִיר	nadir
נִדַּת	nidat
נַהָג	nahag
נָהַג	nahag
נֶהֱדָר	nehedar
נֶהֱנָה	nehena
נָהַר	nahar
נָהָר	nahar
נֶהֱרַג	neherag
נוגה	nogah
נוּגֶה	nuge
נוֹזֵל	nozel
נוֹחַ	noakh
נ־ו־ח	n-w-h  n-h
נַוְטָן	navtan
נוֹלַד	nolad
נוּ״ן	nun
נוּן	nun
נוֹסַד	nosad
נוֹסֵעַ	nosea
נוֹסָף	nosaf
נוֹף	nof
נוֹצְרִי	notsri
נוֹרָא	nora
נוֹרָא	nora
נוֹרְבֶגְיָה	norvegya
נוֹרָה	nora
נוּרָה	nura
נוֹשֵׂא	nose
נוֹשֶׁה	noshe
נִזְבְּחָה	nizbcha
נִזְהָר	nizhar
נָזִיד	nazid
נָזִיר	nazir
נֵזֶר	nezer
נָח	nakh
נַחוּם	nakhum
נַחַ״ל	nakhal
נַחַל	nakhal
נָחַל	nakhal
נֶחְלַשׁ	nekhlash
נֶחֱמַד	nekhemad
נֶחְמָד	nekhmad
נַחְמָן	nakhman
נֶחְקַר	nekhkar
נַחַשׁ	nakhash
נִחֵשׁ	nichesh
נִחֵשׁ	nikhesh
נֶחְשַׁב	nekhshav
נָחַת	nakhat
נָחֵת	nakhet
נָטָה	nata
נָטוּי	natuy
נָטַל	natal
נֵטֶל	netel
נִטֵּל	nitel
נָטַע	nata
נֶטַע	neta
נִיב	niv
נַיָּדִים	nayadim
נְיוּ יוֹרְק	nyu york
נְייַר עֲטִיפָה	niyar atifa
־נִיק	-nik
נְיָר	nyar
נְיָרוֹת	nyarot
נֶכֶד	nekhed
נֶכְדָּה	nekhda
נִכָּה	nika
נָכוֹן	nakhon
נִכּוּר	nikoor
נִכְלַם	nikhlam
נֵכָר	nekhar
נִכָּר	nikar
נִכַּר	nikar
נִכֵּר	niker
נ־כ־ר	n-k-r
נִכְתַּב	nikhtav
נִלְחַם	nilkham
נִלְקַח	nilkakh
נָם	nam
נָמוּךְ	namuch
נִמְחַק	nimkhak
נִמְכַּר	nimkar
נָמֵל	namel
נְמַל־הַתְּעוּפָה	nmal-hatufa
נִמְלַט	nimlat
נִמְנַע	nimna
נָמַס	namas
נִמְצָא	nimtsa
נְמֵרָה	nmera
נֶמֶשׁ	nemesh
נִמְשַׁךְ	nimshakh
נִמְשָׁךְ	nimshakh
נַנָּס לָבָן	nanas lavan
נָס	nas
נֵס	nes
נִסְגַּר	nisgar
נִסָּה	nisa
נֻסָּה	nusa
נָסוּךְ	nasukh
נֻסָּח	nusakh
נֻסְחָה	nuskha
נִסְחַף	niskhaf
נָסִיךְ	nasikh
נִסִּים	nisim
נִסִּים	nisim
נְסִיעָה	nsia
נָסַע	nasa
נָעִים	naim
נָעִים מְאוֹד	naim mod
נְעִימָה	neima
נַעַל	naal
נְעָלֶיךָ	nalecha
נָעֳמִי	noomi
נַעְנַע	nana
נִעְנֵעַ	ninea
נַעַר	naar
נָעַר	naar
נְעָרִים	narim
נַעֲשָׂה	naasa
נַעֲשֶׂה	naase
נִפְגַּע	nifga
נִפְגַּשׁ	nifgash
נָפָה	nafa
נָפוּחַ	nafuakh
נִפְטַר	niftar
נָפִיל	nafil
נְפִילָה	nfila
נָפַל	nafal
נִפֵּץ	nipets
נִפְרַד	nifrad
נִפְרָד	nifrad
נָפַשׁ	nafash
נֶפֶשׁ	nefesh
נֹפֶשׁ	nofesh
נִפְשַׁט	nifshat
נָפַת	nafat
נִצָּב	nitsav
נִצּוּל	nitsul
נֵצַח	netzakh
נֶצַח	netzakh
נִצֵּחַ	nitseakh
נִצָּחוֹן	nitsakhon
נִצֵּל	nitsel
נִצָּן	nitzan
נֵצֶר	netser
נִצֵּר	nitser
נִצְרָה	nitsra
נַצְרוּת	natsrut
נָצְרַת עִלִּית‎	natsrat ilit
נִקְבַּר	nikbar
נְקֻדָּה	nkuda
נִקּוּד	nikud
נָקִי	naki
נְקָמָה	nekama
נִקְרָא	nikra
נִקְרַת	nikrat
נִרְאֶה	nire
נִרְגַּע	nirga
נֵרוֹת	nerot
נִרְצָח	nirtsakh
נַרְתִּיק	nartik
נָשָׂא	nasa
נָשָׁא	nasha
נִשָּׂא	nisa
נִשֵּׂא	nise
נָשָׂא וְנָתַן	nasa vnatan
נִשְׁאַר	nishar
נִשְׁבָּה	nishba
נִשְׁבַּר	nishbar
נָשׂוּא	nasu
נִשּׂוּאִין	nisuin
נִשְׁטַף	nishtaf
נְשִׂיאִים	nsiim
נְשִׁיכָה	neshikha
נָשִׁים	nashim
נָשִׂים	nasim
נְשִׁימָה	neshima
נְשִׁיפָה	neshifa
נְשִׁיקָה	neshika
נִשְׁכַּח	nishkakh
נִשְׁלַט	nishlat
נָשְׁמָה	nashma
נְשָׁמָה	nshama
נִשְׁמַע	nishma
נִשְׁמַר	nishmar
נָשַׁק	nashaq
נ־שׁ־ק	n-sh-q
נֶשֶׁק גַּרְעִינִי	neshek garini
נֶשֶׁר	nesher
נִתּוּחַ	nituakh
נִתְחַכְּמָה	nitchakma
נָתִיב	nativ
נָתָן	natan
נִתַּן	nitan
נְתַנְיָהוּ	ntanyahu
סָב	sav
סַב	sav
סַבָּא	saba
סָבַב	savav
סַבַּבָּה	sababa
סָבָה	sabba
סִבָּה	siba
סִבּוּב	sibuv
סִבּוּבִים	sibuvim
סִבּוּךְ	sibukh
סְבִיבָה	sviva
סְבִיבוֹנִים	svivonim
סְבִירוּת	svirut
סִבִּית	sibit
סָבַל	saval
סַבְלָנוּת	savlanut
סְבָרָה	svara
סָבְתָא	savta
סָגַד	sagad
סָגוּר	sagur
סְגַלְגַּל	sgalgal
סְגֻלָּה	sgula, sgulla
סִגְנוֹן	signon
סַגְסֹגֶת	sagsoget
סָגַר	sagar
סְדוֹם	sdom
סִדּוּר	sidur
סָדִין	sadin
סְדֹם	sdom
סַדְנָה	sadna
סוּבּוֹתְניק	subotnik
סוֹבְלָנוּת	sovlanut
סִוֵּג	siveg
סוּג	sug
סוּגָה	suga
סוּג שֶׁל	sug shel
סוֹד	sod
סוֹלְלָה	solla
סוּנִי	suni
סוֹף	sof
סוֹף סוֹף	sof sof
סוֹפִי	sofi
סוֹפִית	sofit
סוֹפֵר	sofer
סוּפֶּר	super
סוּפֶּרְפּוֹזִיצְיָה	superpozitsya
סוֹצְיָאלִיזְם	sotsyalizm
סוּשִׁי	sushi
סְחוֹרָה	skhora
סָחַט	sakhat
סְטָטִיסְטִיקָה	statistika
סְטִירָה	stira
סְטִירוֹת	stirot
סְטִירַת	stirat
סְטֶנְדְּאָפּ	stendap
סְטֶנְדְאַפִּיסְט	stendapist
סִיגְד	sigd
סִיגַרְיָה	sigarya
סִידָן	sidan
סִיּוּט	siyut
סִיּוּם	siyum
סִיוָן	sivan
סִימֶטְרִי	simetri
סִימָן	siman
סִימָן־מוּלָד	siman-mulad
סִין	sin
סִינַי	sinay
סִינִי	sini
סִינִית	sinit
סִיסְמָה	sisma
סִיעָה	sia
סַיִף	sayif
סִירָה	sira
סִכּוּי	sikui
סַכּוּ״ם	sakum
סֻכּוֹת	sukot
סַכִּין גִּלּוּחַ	sakin giluakh
סַכִּין יַפָּנִי	sakin yapani
סָכָל	sakhal
סֶכֶל	sekhel
סֻכַּל	sukal
סִכֵּן	siken
סַכָּנָה	sakana
סֶכֶר	sekher
סֻכָּר	sukar
סֻכְּרָזִית	sukrazit
סֻכֶּרֶת	sukeret
סָלוֹן	salon
סָלַח	salakh
סָלַל	salal
סֻלָּם	sulam
סַלְמוֹן	salmon
סְלֶנְג	sleng
סַם פֶּלֶא	sam pele
סְמוֹל טוֹק	smol tok
סָמֶ״ךְ	samekh
סַמָּל	samal
סִמֵּן	simen
סְנָאִי	snai
סֶנְדְוִיץ׳	sendvich
סַנְדָּל	sandal
סַנְהֶדְרִין‎	sanhedrin
סָנַט	sanat
סֶנְט	sent
סַנְטֵר	santer
סִנְכְּרֵן	sinkren
סֻנְכְּרַן	sunkren
סְנַפִּירִים	snapirim
סַנְקְצְיָה	sanktsya
סְעִיף	seif
סְעָרָה	seara
סָפַג	safag
סֻפְגָּנִיָּה	sufganiya
סֻפְגָּנִיָּה	sufganiya
סֻפְגָּנִיּוֹת	sufganiyot
סָפַד	safad
סַפָּה	sapa
סְפּוֹדִיק	spodik
סְפּוֹרְטַאי	sportai
סָפִיר	safir
סַפִּיר	sapir
סְפִירָה	sfira
סַפְסָל	safsal
סָפֵק	safek
סַפָּק	sapak
סִפֵּק	sipek
סְפֵקוֹת	sfekot
סָפַר	safar
סַפָּר	sapar
סִפֵּר	siper
סֵפֶר בְּרֵאשִׁית‎	sefer breshith
סֵפֶר בִּשׁוּל	sefer bishul
סְפָרַד	sfarad
סְפָרַדִּי	sfaradi
סְפָרַדִּית	sfaradit
סַפְרָה	safra
סְפֶרָה	sfera
סִפְרָה	sifra
סִפְּרָה	sipra
סִפְרוּת	sifrut
סִפְרִיָּה	sifriya
סֵפֶר לִמּוּד	sefer limud
סְצֵנָה	stzena
סֶקְסוּאָלִי	seksuali
סֶקְסִי	seksi
סָקַר	sakar
סַקְרָן	sakran
סִקְרֵן	sikren
סַקְרָנוּת	sakranut
סֵרַב	serav
סֶרְבּוֹ־קְרוֹאָטִית	serbo-kroatit
סֶרֶט	seret
סֶרֶט מַגְנֵטִי	seret magneti
סַרְטַן יָם	sartan yam
סָרַק	sarak
סָרָק	sarak
סְתָו	stav
סָתוּם	satum
סְתִירָה	stira
סָתַם	satam
סְתָם	stam
סְתָ״ם	stm, stam
סְתָמִי	stami
עָב	av
עֶבֶד	eved
עָבְדָה	avda
עַבְדָּהּ	avdah
עֲבֹדָה	avoda
עִבְּדָה	ibda
עֻבְדָּה מֻגְמֶרֶת	uvda mugmeret
עַבְּדוּ	abdu
עֲבָדוֹ	avado
עָבְדוּ	avdu
עִבְדוּ	ivdu
עַבְדְּךָ	avdcha
עִבַּדְתֶּם	ibadtem
עֲבוֹט	avot
עֲבוּר	avur
עָבַר	avar
עֲבֵרָה	avera
עֶבְרָה	evra
עִבְרִי	ivri
עִבְרִים	ivrim
עִבְרִית	ivrit
עִבְרִיֹּת	ivriyot
עַגְבָנִיָּה	agvaniya
עַגְבָנִיּוֹת	agvaniyot
עֻגוֹת	ugot
עֵגֶל	egel
עָגַן	agan
עֹגֶן	ogen
עַד	ad
עֵד	ed
עֵדָה	eda
עֵדוּת	edut
עֵדִים	edim
עֲדַיִן	adayin
עָדִיף	adif
עֲדִיפוּיוֹת	adiyfuyot
עֲדִיפוּת	adiyfut
עַדֶּן	aden
עֵדֶן	eden
עֹדֶף	odef
עָדַר	adar
עֵדֶר	eder
עֲדָשָׁה	adasha
עוֹבַדְיָה	ovadia
עוּגָה	uga
עוּגִיָּה	ugia
עוֹד	od
עוֹדֵד	oded
עוֹדֵף	odef
עוֹכֵר שִׂמְחָה	okher simkha
עַוְלָה	avla
עוֹלָה	ola
עוֹלֶה	ole
עוֹלָמִי	olami
עוֹמֵד	omed
עוֹנָה	ona
עוֹף	of
עוֹר	or
עוֹרֵב	orev
עוֹרוֹת	orot
עוֹרֵךְ	orekh
עוֹרֵךְ דִּין	orekh din
עוֹרֶכֶת דִּין	orekhet din
עוֹרֵר	orer
עַז	az
עֵז	ez
עֲזָאזֵל	azazel
עָזַב	azav
עֲזַבְתֶּן	azavten
עַזָּה	aza
עֵזֶר	ezer
עֶזְרָה	ezra
עֵט	et
עֲטִיפָה	atifa
עֲטָרָה	atara
עַיִט	ayit
עַיִ״ן	ayin
עִיֵּן	iyen
עָיֵף	ayef
עִיֵּף	iyef
עִיר	ir
עֵירוֹם	erom
עִירוֹנִי	ironi
עִירִיָּה	iriya
עַכָּבִישׁ	akavish
עַכְבָּר	akhbar
עַכּוֹ	ako
עַכּוּז	akuz
עִכּוּל	ikul
עַכְשָׁו	akhshav
עֲכְשָׁוִי	akhshavi
עֲכְשָׁוִית	akhshavit
עַל	al
עַל אָחַת כַּמָּה וְכַמָּה	al akhat kama vkhama
עָלָה	ala
עָלֶה	ale
עָלוּב	aluv
עָלֵז	alez
עַל טַעַם וְרֵיחַ אֵין לְהִתְוַכֵּחַ	al taam vreakh en lhitvakeach
עֲלֵי	alei
עֵלִי	eli
עֲלִיָּה	aliya
עָלָיו	alav
עֲלֵיכֶם שָׁלוֹם	aleikhem shalom
עָלֵינוּ	alenu
עַל־כֵּן	al-ken
עַל לֹא דָבָר	al lo davar
עֶלֶם	elem
עֹלָם	olam
עַלְמָה	alma
עַל־פִּי	al pi
עַל רֶגֶל אַחַת	al regel achat
עֶמְדָּה	emda
עַמּוֹ	amo
עִמּוֹ	imo
עַמּוּד	amud
עמוד בית	amud-bayit
עֲמוּדֵי בַיִת	amude vayit
עָמוֹס	amos
עִמִּי	imi
עַמִּים	amim
עָמִית	amit
עִמָּנוּאֵל	imanuel
עָמַק	amak
עָמֹק	amok
עֵמֶק	emek
עֹמֶק	omek
עֹמֶר	omer
עֵנָב	einav
עֹנֶג	oneg
עֹנֶג	oneg
עֹנִי	oni
עָנְיָם	onyam
עִנְיָן	inyan
עָנָן	anan
עָנָף	anaf
עֲנָקִי	anaki
עַנֹּתוֹ	anoto
עָסוּק	asuk
עִסּוּק	isuk
עִסְקִי	iski
עָף	af
עֲפִיפוֹן	afifon
עַפְעַף	afaf
עָפָר	afar, apar
עֹפֶר	ofer
עֹפֶר	ofer
עַפְרָה	afra
עֶפְרוֹנוֹת	efronot
עָצוּב	atsuv
עִצּוּב	itsuv
עָצוּם	atsum
עִצּוּר	itsur
עֵצִים	etsim
עָצַם	atsam
עַצְמָאוּת	atsmaut
עָצַר	atsar
עָקֵב	akev
עֵקֶב	ekev
עֲקִיבָא	akiva, aqiba
עָקַץ	akats
עָקַר	akar
עִקָּר	ikar
עַקְרָב	akrav
עַקְרַבִּים	akrabim
עַקְשָׁן	akshan
עַקְשָׁנוּת	akshanut
עֵר	er
עֲרָב	arav
עָרַב	arav
עָרֵב	arev
עֶרֶב	erev
עֲרָבוֹת	aravot
עֲרֵבוּת	arevut
עַרְבוּת	arvut
עַרְבֵי	arve
עַרְבַּיִם	arbayim
עַרְבִית	arvit
עָרוּם	arum
עָרוּץ	aruts
עֲרִיכוֹת	arikhot
עֵרֶך	erekh
עָרְלָה	orla
עָרְלַת	orlat
עָרֹם	arom
עַרְסָל	arsal
עַרְעָר	arar
עֲרָפֶל	arafel
עַרַק	araq
עָרַק	araq
עֶרֶשׂ	eres
עָשׁ	ash
עֵשֶׂב	esev
עָשָׂה	asa
עָשָׂה כְּבִיסָה	asa kvisa
עֲשׂוּ	asu
עָשׂוּ	asu
עֵשָׂו	esav, esaw
עִשּׁוּן	ishun
עָשִׁיר	ashir
עֲשִׂיתֶן	asiten
עִשֵּׁן	ishen
עִשֵּׁן	ishen
עֲשָׂרָה	asara
עִשָּׂרוֹן	isaron
עֶשְׂרִים	esrim
עֵת	et
עַתָּה	ata
עִתּוֹן	iton
עִתּוֹנָאוּת	itonaut
עִתּוֹנָאִי	itonai
עִתּוֹנַאי	itonai
עָתִיד	atid
עֲתִידִי	atidi
עָתֵק	atek
פָּאָה	paa
פֵּאָה	pea
פַּאי	pai
פְּאֵר	peer
פֵּאֵר	peer
פִּגְיוֹן	pigyon
פָּגִיעַ	pagia
פְּגִיעָה	pgia
פְּגִישָׁה	pgisha
פָּגַע	paga
פֶּגַע	pega
פִּדְיוֹן	pidyon
פָדִיחָה	fadikha
פָה	fa
פֶּה	pe
פּוֹזָה	poza
פּוֹלִיגְרָף	polygraf
פּוֹלִיטִיקָה	politika
פּוּנְדָק‎	pundak
פּוֹעֵל	poel
פּוֹעֶלֶת	poelet
פּוּצָּה	putsah
פּוֹצֵץ	potsets
פוֹרוּם	forum
פּוּרִים	purim
פּוּרִים	purim
פוֹרְמָלִי	formali
פּוֹרְנוֹגְרָפִי	pornografi
פּוֹרְנוֹגְרַפְיָה	pornografya
פָּז	paz
פִּזְמוֹן	pizmon
פַּח	pakh
פַּחַד	pakhad
פִּחֵד	pikhed
פַּחְדָן	pakhdan
פֶּחָם	pekham
פָּטוּר	patur
פְּטוֹר	ptor
פָּטוּר אֲבָל אָסוּר	patur aval asur
פִּטְרִיָּה	pitriya
פִי	fi
פַּי	pay
פִּיהוּ	pihu
פִּיו	piv
פִיזִי	fizi
פִּיךְ	pich
פִּיל	pil
פִּילֶגֶשׁ	pilegesh
פִּילוֹסוֹף	pilosof, pilosop
פִּין	pin
פִּינְג פּוֹנְג	ping pong
פִינְלַנְד	finland
פִּיצָה	pitsa
פיקוח נפש	pikuakh nefesh
פִּירוֹטֶכְנִיקָה	pirotekhnika
פִּירָמִידָה	piramida
פַּךְ	pakh
פֶּלֶא	pele
פְּלָדָה	plada
פְלוּאוֹר	fluor
פלוּטוֹ	pluto
פָלוּס	falus
פֻּלְחָן	pulkhan
פֻּלְחָנִי	pulkhani
פָלִי	fali
פְלִירְטוּט	flirtut
פְלָמִינְגּוֹ	flamingo
פָלַסְטִין	falastin
פְּלָסְטִיק	plastik
פְּלַסְטֶר	plaster
פִּלְפּוּל	pilpul
פִּלְפֵּל	pilpel
פִּלְפְּלים	pilplim
פִּלְפֵּל לָבָן	pilpel lavan
פִּלְפֵּל שָׁחֹר	pilpel shachor
פְלֶשׁ	flesh
פְּלִשְׁתִּים	plishtim
פֶן	fen
פָּן	pan
פֶּן	pen
פֻּנְדָּק	pundak
פָּנָה	pana
פִּנָּה	pina
פָּנוּי	panuy
פִּנּוּי	pinui
פָּנוּיָה	panuya
פְּנֵי־	pnei-
פָּנִים	panim
פְּנִימָה	pnima
פָּנָס	panas
פַּנְצֶ׳ר	pancher
פִנֵּק	pinek
פָּסוּק	pasuk
פָּסַח	pasach
פֶּסַח	pesach
פַּסְחָא	paskha
פִּסְּחִים	piskhim
פְּסָחִים	psachim
פְּסִיכוֹלוֹג	psikholog
פְּסִיכוֹלוֹגְיָה	psikhologya
פְּסִיכִיאָטְרִי	psikhiatri
פַּסָּל	pasal
פָּסַל	pasal
פֶּסֶל	pesel
פִּסֵּל	pisel
פַּסֶּלֶת	paselet
פְּסֹלֶת	psolet
פְּסַנְתֵּר	psanter
פְּסַנְתֵּרִים	psanterim
פִּסְפֵּס	pispes
פָּסַק	pasak
פָּסֵק	pasek
פְּסָק	psak
פֻּסַּק	pusak
פִּסְקָה	piska
פָּעִיל	pail
פְּעִילוּת	pilut
פָּעַל	paal
פִּעֵל	piel
פֹּעַל	poal
פֹּעַל	poal
פֻּעַל	pual
פְּעָלִים	pealim
פַּעַם	paam
פָּעַם	paam
פִּעֵם	piem
פַּעֲמוֹנִים	paamonim
פָּצִיפִיזְם	patsifizm
פְּצָצָה	petzatza
פְּצָצָה אֲטוֹמִית	petzatza atomit
פָּקַד	pakad
פָּקַדְתִּי	pakadti
פִּקֵּחַ	pikeach
פָּקַק	pakak
‎פַּר‎	par
פַּרְבָּר	parbar
פָּרָג	parag
פָּרָדִיגְמָה	paradigma
פַּרְדֵּס	pardes
פָּרָה‎	para
פָּרָה	para
פָּרוֹ	paro
פְּרוֹ־	pro-
פְּרוּ	pru
פְּרוֹבִינְצְיָה	provintsya
פְּרוֹזְבּוֹל	prozbol
פְּרוֹיֶקְט	proyekt
פרויקטים	proyektim
פְּרוּסָה	prusa
פְּרוֹפֶסוֹר	profesor
פָּרוֹת	parot
פֵּרוֹת	perot
פָּרַח	parakh
פֶּרַח	perakh
פְרֵחָה	frekha
פְּרָחִים	prakhim
פְּרָטִי	prati
פְּרִי	pri
פֶּ‏רִיגֵיאָ‏ה	perigea
פָּרִיז	pariz
פְרָיֶר	fraier
פַרְמָקוֹלוֹגְיָה	farmakologya
פָּרָנוֹאִידִי	paranoidi
פָּרַס	paras
פָּרָס	paras
פְּרָס	pras
פַּרְסִי	parsi
פִּרְסֵם	pirsem
פֻּרְסַם	pursam
פִּרְסְמָה	pirsma
פֶּרְסְפֶּקְטִיבָה	perspektiva
פַּרְעֹה	paro
פַּרְעוֹנֵי־	paronei-
פַּרְעוֹשׁ	parosh
פַּרְפָּרִים	parparim
פָּרַץ	parats
פֶּרֶץ	perets
פַּרְצוּף	partsuf
פָּרַק	parak
פַּרְק	park
פֶּרֶק	perek
פְּרָקִים	prakim, praqim
פְּרַקְלִיט	praklit
פָּרָשׁ	parash
פָּרַשׁ	parash
פָּרָשָׁה	parasa
פִּשּׁוּט	pishut
פָּשַׁט	pashat
פִּשֵּׁט	pishet
פֻּשַּׁט	pushat
פָּשַׁט אֶת הָרֶגֶל	pashat et haregel
פַּשְׁטוֹ	pashto
פְּשִׁיטַת־רֶגֶל	pshitat-regel
פֶּשַׁע	pesha
פָּשַׁר	pashar
פִּשֵּׁר	pisher
פִּשְׁתָּה	pishta
פֹּת	pot
פִּתְאוֹם	pitom
פִּתְאוֹמִי	pitomi
פִּתְגָּם	pitgam
פָּתוּחַ	patuakh
פִּתּוּחַ	pituakh
פָּתוֹלוֹג	patolog
פָּתוֹלוֹגְיָה	patologia
פַתְ״ח	fatkh
פַּתַח	patakh
פָּתַח	patakh
פֶּתַח	petakh
פִּתֵּחַ	piteakh
פֶּתַח תִּקְוָה	petakh tikva
צֹאן	tson, son
צַב	tsav
צָבָא	tsava
צִבְאוֹת־	tsivot-
צְבָאוֹת	tsvaot
צִבּוּר	tsibur
צְבִי	tsvi
צַבָּע	tsaba
צָבַע	tsava
צֶבַע	tseva
צְבָעִים	tsvaim
צַד	tsad
צַדִּיק	tsadik
צָדַק	tzadak
צֶדֶק	tzedek
צְדָקָה	tsdaka
צְדָקִים	tsdakim
צָהֹב	tsahov
צָהֳלָה	tsohola
צָהֳרַיִם	tsohorayim
צַו	tsav
צַוָּאָה	tzavaa
צַוָּארוֹן	tsavaron
צוֹדֵק	tsodek
צִוָּהוּ	tsivahu
צו הרחקה	tsav-harkhaka
צ׳וֹלְנְט	cholnt
צוֹם	tsom
צוּנַמי	tsunami
צוֹעֲנִי	tsoani
צ׳וּפְּצִ׳יק	chupchik
צוּר	tsur
צוּרָה	tsura
צֶוֶת	tsevet
צְחוֹק	tskhok
צָחִיחַ	tsakhiakh
צָחַק	tsakhak
צִטּוּט	tsitut
צִטֵּט	tsitet
צֻטַּט	tsutat
צַיִד	tsayid
צִידוֹן	tsidon
צַיָּדֵי	tsayadei
צַיָּדִים	tsayadim
צַיֶּדֶת	tsayedet
צִיּוּן	tsiyun
צִיּוֹנוּת	tsiyonut
צִיּוּנִים	tziyunim
צִיּוּרֵי־	tsiyurei-
צִיּוּרִי	tsiyuri
צ־י־ן	ts-y-n
צֵ׳יְסֶר	cheyser
צִ׳יפְּס	chips
צִיץ	tsits
צִיצִיּוֹת	tsitsiyot
צִיצִית	tsitsit
צִיצִת	tsitsit
־צִ׳יק	-chik
צִ׳יק צָ׳ק	chik-chak
צִיֵּר	tsiyer
צֵל	tsel
צָלַב	tzalav
צְלָב	tzlav
צָלוּל	tsalul
צִלּוּם	tzilum
צַלַּחַת	tsalachat
צְלִיל	tslil
צֶלֶם	tselem
צֶלַע	tsela
צָלַע	tsolea
צְלָפְחָד‎	tslofchad
צָם	tsam
צַמָּה	tsama
צֶמַח	tsemakh
צמיגים	tzmigim
צְנוֹן	tsnon
צָנוּעַ	tsanua
צְנִיעוּת	tsniut
צָעִיר	tzair
צְעִירָה	tsira
צָפָה	tsafa
צִפָּה	tsipa
צָפוּי	tsafui
צָפוּן	tsafun
צָפוֹן	tzafon
צִפּוֹר	tsipor
צִפּוֹרָה	tsipora
צְפַרְדֵּעַ	tzfardea
צְפַת	tsfat
צַר	tsar
צֹר	tsor
צָרָה	tsara
צרוף לשון	tzeiruf lashon
צָרוּר	tsarur
צְרוֹר	tsror
צָרוֹת	tsarot
צָרוּת	tsarut
צָרַח	tsarakh
צָרִיךְ	tsarikh
צָרִים	tsarim
צָרַךְ	tsarakh
צֹרֶךְ	tsorekh
צַרְכָן	tzarchan
צִרְעָה	tzirah
צָרַעַת	tsaraat
צֵרֵף	tseref
צָרְפַת	tsarfat
צָרְפָתִית	tsarfatit
צַרְצוּר	tzartzur
צִרְצוּר	tzirtzur
צְרָצַר	tsratsar
צַתְרָה	tsatra
קֵבָה	keva
קִבּוּץ	kibutz
קְבוּצוֹת	kvutzot
קְבוּצַת־	kvutzat
קִבֵּל	kibel
קַבָּלָה	kabala
קַבָּלוֹת	kabalot
קַבְּצָן	kabtzan
קָבַר	kavar
קֶבֶר	kever
קִבֹּרֶת	qiboret
קָדוּם	kadum
קָדוֹשׁ	kadosh
קִדּוּשׁ	kidush
קִדּוּשׁ	kidush
קַדַּחַת	kadakhat
קָדִימָה	kadima
קַדִּישׁ	kadish
קָדַם	kadam
קְדַם־	kdam-
קֶדֶם	kedem
קִדֵּם	kidem
קֹדֶם	kodem
קִדְמִי	kidmi
קָדְקֹד	kodkod
קֹדֶשׁ	kodesh
קֻדַּשׁ	kudash
קֻדַּשׁ	kudesh
קַדְּשֵׁנוּ	kadshenu
קִדְּשָׁנוּ	kidshanu
קַהְוָה, קַהֲוָה	kahva, kahava
קָהִיר	kahir
קְהִלָּה	khila
קַו	kav
קוֹאוֹפֵּרָטִיב	kooperativ
קוֹאָלִיצְיָה	koalitsya
קוֹדֵחַ	qodeakh
קִוָּה	kiva
קוֹטֶג׳	kotej
קוֹל	kol
קוֹלְחוֹז	kolkhoz
קוֹלָן	kolan
קוֹלָנִי	kolani
קוֹל קוֹרֵא	kol kore
קוּם	kum
קוֹמְבִּינָה	kombina
קוּמוּלוּס	kumulus
קוּמְזִיץ	kumzits
קוֹנְדּוֹם	kondom
קוֹנְדּוֹמִים	kondomim
קוֹנְדִיטוֹר	konditor
קְוַנְט	kvant
קוֹנְסֶרְבָטִיבִי	konservativi
קוֹנְסֶרְבָטִיבִית	konservatit
קוֹסֵם	kosem
קוֹף	kof
קוּ״ף	kuf
קוּף	kuf
קוּפִּידוֹן	kupidon
קוֹפִים	kofim
קוֹץ	qotz
קוֹצֵר	kotser
קוּקוּ	kuku
קוּקִית	kokit
קוּר	kur
קו רוחב	kav rokhav
קוֹרֵיאָה	korea
קוּרְס	kurs
קָט	kat
קֹטֶב	kotev
קָטְבִּי	kotbi
קָטֵגוֹרְיָה	kategorya
קְטִילָה	ktila
קָטַל	katal
קִטֵּל	kitel
קִטְלֵג	kitleg
קְטֵלָה	ktela, qtela
קְטֻלָּה	ktula, qtulla
קִטָּלוֹן	kitalon, qittalon
קְטַלְטַל	ktaltal, qtaltal
קַטְלָנִי	katlani
קָטָן	katan
קָטֹן	katon
קָטַף	kataf
קָטָר	qatar
קִטֵּר	qiter
קֹטֶר	qoter
קִיבּוּץ	kibutz
קִיבּוּצְנִיק	kibutznik
קַיְטָנָה	kaitana
קַיָּם	kayam
קִיֵּם	kiyem
קַיִן	kayin
קַיִץ	kayits
קֵיצִים	kayitsim
קִיר	kir
קֵל	kel
קֹל	qol
קַל דַּעַת	kal daat
קַלָּה	kala
קָלָה	qala
קַלּוֹת	qalot
קַלּוּת	qalut
קָלַט	kalat
קָלִיגְרָפְיָה	kaligrafya
קְלִיד	klid
קְלִיפּ	klip
קְלִיפָה	klifa
קְלָלָה	klala
קַלְמָר	kalmar
קַלְמָרִין	kalmarin
קָלַף	kalaf
קְלָף	klaf
קְלִפָּה	klipa
קִלְקֵל	kilkel
קָם	kam
קֶמַח	kemakh
קְנָאוֹת	knaot
קַנָאִי	kanai
קָנָה	kana
קִנּוּחַ	kinuach
קִנֵּחַ	kineach
קִנְטֵר	qinter
קֶנְיָה	kenya
קְנִיָּה	kniya
קִנִּים	kinim
קְנִישׁ	knish
קִנָּמוֹן	kinamon
קִנָּמוֹן	kinamon
קַסְדָּה	kasda
קֶסֶם	kesem
קֶסֶת	keset
קַעֲקַע	kaaka
קִעְקֵעַ	lt--israeli native says kiakea, niqqud say niekea--gt
קְעָרָה	qearah
קַעֲרִית	qaarit
קָפָא	kafa
קָפָּא	kappa
קִפָּאוֹן	kipaon
קָפֶה	kafe
קָפֶה הָפוּךְ	kafe hafukh
קָפֶה נָמֵס	kafe names
קָפֶה קָפוּא	kafeh kafu
קַפְרִיסִין	qafrisin
קֵץ	kets
קְצִיצָה	ktsitsa
קְצִיצוֹת	ktsitsot
קָצָר	katsar
קֹצֶר	kotser
קְצַרְצַר	ktsartsar
קְצָת	ktsat
קָקָאוֹ	kakao
קק״ל	kkl
קֹר	kor
קָרָא	kara
קָרָאִי	karai
קִרְאֶן	kiren
קְרַב אִגְרוּף	krav igruf
קָרְבָּן	korban
קָרְבָּנוֹת	korbanot
קָרָה	qara
קָרוּא	karu
קְרוֹבָה	krova
קְרוֹבוֹת	krovot
קָרָוָן	qaravan
קֵרֵחַ	kereakh
קֹרַח	korakh
קַרְחוֹן	karkhon
קַרְחִי	karkhi
קָרִיא	kari
קְרִיזָה	kriza
קֶרִי לַיְלָה	keri layla
קְרִיקֶט	kriket
קִרְיַת גַּת‎	kiryat gat
קִרְיַת שְׁמוֹנָה‎	kiryat shmona
קֶרֶן	keren
קֶרֶן	keren
קָרַע	qara
קַרְפָּד	karpad
קַשׁ	kash
קַשָּׁב	kashav
קָשֶׁה	kashe
קָשׁוּר	kashur
קִשּׁוּר	kishur
קֹשִׁי	koshi
קָשִׁיחַ	kashiakh
קָשִׁישׁ	kashish
קְשִׁישָׁה	kshisha
קַשָּׁר	kashar
קָשַׁר	kashar
קִשֵּׁר	kisher
קֶשֶׁת	keshet
קְשָׁתוֹת	kshatot
קָתֶדְרָלָה	katedrala
רֹאֶה	roe
רָאוּי	raui
רֵאוֹת	reat
רֵאוֹת	reot
רֵאוֹת	reot
רְאוֹת	rot
רְאוּת	rut
רְאָיָה	reaya
רְאִיָּה	reiya
רֵאָיוֹן	reayon
רָאִינוּ	rainu
רָאִיתִי	raiti
רְאֵם	rem
רֹאשׁ	rosh
רֹאשׁ הַשָּׁנָה	rosh-hashana
רִאשׁוֹן לְצִיּוֹן	rishon ltsiyon
רִאשׁוֹנָה	rishona
רָאשֵׁי	rashei
רָאשִׁי	rashi
רָאשִׁים	rashim
רָאשֵׁי תֵבוֹת	rashei teivet
רֹאשָׁן	roshan
רֹאשָׁנִים	roshanim
ראש עירייה	rosh iria
רַב	rav
רָבָה	rava
רִבּוֹנֵי	ribonei
רִבּוֹנִי	riboni
רִבּוּעַ	ribua
רַבִּי	rabi
רִבִּית	ribit
רַב־מַלְאָךְ	rav-malakh
רַבֵּנוּ	rabeinu
רַבָּנִים	rabanim
רֹבַע	rova
רֹבַע	rova
רִבְעוֹן	rivon
רַבְשָׁקֵה	ravshake
רָגוּעַ	ragua
רֶגֶל	regel
רַגְלָיו	raglav
רגליך	raglcha
רַגְלֶיךָ	raglecha
רֶגַע	rega
רֹגַע	roga
רְגָעִים	rgaim
רֶגֶשׁ	regesh
רְגָשׁוֹת	rgashot
רַדְיוֹ	radyo
רָהוּט	rahut
רִהוּט	rihut
רָהִיט	rahit
רְהִיטוּת	rhitut
רוֹאֶה	roe
רוֹאֵה חֶשְׁבּוֹן	roe kheshbon
רוֹבֶה	rove
רוּגַאֲטְקָה	rugatqa
רוֹגֵעַ	rogea
רוּחָנִי	rukhani
רוּחָנִיּוֹת	rukhaniyot
רוּחָנִיּוּת	rukhaniyut
רְוָיָה	revaya
רוּם	rum
רוֹמָא	roma
רוֹמַם	romam
רוֹמֵם	romem
רוֹמָן	roman
רוֹמַנְיָה	romanya
רוֹמָנִית	romanit
רוּסִי	rusi
רוּסְיָה	rusya
רוּסִית	rusit
רוֹפֵא	rofe
רוֹפְאָה	rofa
רוֹצָה	rotsa
רוֹצֶה	rotse
רַוָּק	ravak
רַוָּק	ravaq
רוֹק	roq
רוֹקֵחַ	rokeakh
רוֹתֵחַ	roteakh
רָחָב	rachav
רְחַב יָדַיִם	rakhav yadayim
רְחוֹבוֹת	rkhovot
רָחוֹק	rakhok
רָחֵל	rachel
רָחַם	rakham
רֶחֶם	rekhem  rakham
רִחֵם	rikhem
רַחֲמִים	rakhamim
רַחְמָנוּת	rakhmanut
רָחַץ	rachats
רָטֹב	ratov
רֹטֶב	rotev
רָטוּב	ratuv
רֶטְרוֹאַקְטִיבִי	retroactivi
רֵיחַ	reakh
רֵיחָן	rehan
רִיס	ris
רִיסִים	risim
רֵיק	reik
רַךְ	rakh
רֹךְ	rokh
רָכַב	rakhav
רֶכֶב	rechev
רַכֶּבֶל	rakevel
רַכֶּבֶת	rakevet
רִכּוּז	rikuz
רָם	ram
רַמְבַּ״ם	rambam
רַמְבַּ״ן	ramban
רָמָה	rama
רִמָּה	rima
רִמּוֹנָדָה	rimonada
רִמּוֹנִים	rimonim
רָמַז	ramaz
רֶמֶז	remez
רַמְזוֹר	ramzor
רַמְלָה	ramla
רֶמֶץ	remets
רָמַשׂ	ramas
רַן	ran
רֹן	ron
רִנָּה	rina
רִסֵּס	rises
רַע	ra
רָעָב	raav
רָעֵב	raev
רָעַד	raad
רָעָה	raa
רֵעָה	rea
רְעוּאֵל	ruel
רֹעִי	roi
רַעֲיוֹן	raayon
רֵעֲךָ	reacha
רַעַם	raam
רַעְמְסֵס	ramses
רַעֲנַנָּה	raanana
רָעַשׁ	raash
רַעֲשָׂן	raashan
רַעֲשָׁנִי	raashani
רִפֵּא	ripe
רֻפַּד	rupad
רְפוּאָה	rfua
רֶפּוּבְּלִיקָה	republika
רַפְסוֹדָה	rafsoda
רֶפֶת	refet
רָץ	ratz
רִצָּה	ritsa
רָצוּי	ratzui
רָצוֹן	ratzon
רָצוֹן טוֹב	ratzon tov
רְצוּעָה	rtsua
רֶצַח	retzakh
רְצִינִי	rtsini
רִצְפָּה	ritspa
רֹק	roq
רָקַד	rakad
רַקְדָן	rakdan
רַקְדָנִית	rakdanit
רָקוּב	rakuv
רִקּוּד	riqud
רָקֶטָה	raketa
רֶקְטוּם	rektum
רָקִיעַ	rakia
רָקַע	raka
רִקַּע	rika
רֻקַּע	ruka
רִשּׁוּת	rishut
רְשִׁימָה	rshima
רְשִׁימוֹת	reshimot
ר־שׁ־ם	r-sh-m
רִשְׁמִי	rishmi
רָשָׁע	rasha
רֶשָׁע	resha
רִשְׁעוּת	rishut
רְשָׁעִים	rshaim
רֶשֶׁף	resheph
רֶשֶׁת	reshet
רִשֵּׁת	rishet
רַתָּךְ	ratakh
רִתֵּךְ	ritekh
רֻתַּךְ	rutakh
שָׁאוּל	shaul
שָׁאַל	shaal
שְׁאֵלָה	shela
שְׁאָר	shar
שָׁב	shav
שֵׁב	shev
שְׁבָבִים	shvavim
שְׁבָה	shva
שָׁבוּי	shavuy
שָׁבוּעַ	shavua
שְׁבוּעָה	shvua
שָׁבוּעוֹת	shavuot
שְׁבוּעוֹת	shvuot
שְׁבוּעַיִם	shvuayim
שָׁבוּר	shavur
שִׁבֵּחַ	shibeakh
שֻׁבַּח	shubakh
שֵבֶט	shevet
שִׁבְטִי	shivti
שְׁבִיל	shvil
שְׁבִיל הֶחָלָב	shvil hekhalav
שֹׁבֶל	shovel
שַׁבְּלוּל	shablul
שִׁבֹּלֶת	shibolet, sibbolet
שִׁבֹּלֶת שׁוּעָל	shibbolet shual
שֶׁבַע	sheva
שֹׂבַע	sova
שִׁבְעָה	shiva
שָׁבָץ	shavats
שָׁבַר	shavar
שֶׁבֶר	shever
שֻׁבַּר	shubar
שִׂבֵּר	siber
שְׁבָרִים	shvarim
שֶׁבֶת	shevet
שַׁבְּתַאי	shabtai
שַׁבָּתוֹן	shabaton
שַׁבָּת שָׁלוֹם	shabat shalom
שְׁגִיאַת כְּתִיב	shgiat ktiv
שִׁגֵּעַ	shigea
שִׁגֵּר	shiger
שַׁגְרִיר	shagrir
שַׁגְרִירוּת	shagrirut
שַׁגְרִירִים	shagririm
שָׁד	shad
שֵׁד	shed
שֹׁד	shod
שֹד	shod
שָׂדֶה	sade
שִׁדּוּר חוֹזֵר	shidur-khozer
שָׁדַיִם	shadayim
שֶׁדֶר	sheder
שְׂדֵרוֹת‎‎	sderot
שַׁדְרָן	shadran
שֶׂה	se, se
שְׁוָא	shva
שׁוֹאוֹת	shoot
שׁוּב	shuv
שׁוֹדֵד	shoded
שְׁוֶדְיָה	shvedya
שָׁוֶה	shave
שִׁוּוּק	shivuk
שׁוֹחֵט	shokhet
שׁוֹט	shot
שׁוֹטֶה	shote
שׁוֹטֵט	shotet
שׁוֹטֵר	shoter
שׁוֹטְרוֹת	shotrot
שׁוֹטֶרֶת	shoteret
שׁוּל	shul
שׁוֹמֵר	shomer
שׁוּמֶר	shumer
שׁוֹמְרִים	shomrim
שׁוֹנֶה	shone
שׁוּעָל	shual
שׁוֹפֵט	shofet
שׁוֹפְטִים	shoftim
שׁוֹפְכָן	shofkhan
שׁוֹפָר	shofar
שִׁוֵּק	shivek
שׁוֹק	shok
שׁוּק	shuk
שׁוֹר	shor
שׁוּרָה	shura
שׁוּרוּק	shuruk
שׁוּרוֹת	shurot
שׁוֹרֵשׁ	shoresh
שׁוּרַת	shurat
שׁוֹשָׁן	shoshan
שׁוּשָׁן	shushan
שׁוֹשַׁנָּה	shoshana
שׁוֹשַׁנָּה	shoshana
שֹׁחַד	shokhad
שָׂחָה	sakha
שְׁחוֹר	shkhor
שִׁחְזוּר	shikhzur
שְׁחִיטָה	shkhita
שְׁחִיתוּת	shkhitut
שְׁחַמְחַם	shkhamkham
שַׁחְמָט	shakhmat
שְׁחָקִים	shkhakim
שַׂחְקָן	sakhqan
שַׂחְקָנִים	sakhkanim
שַׂחְקָנִית	sakhkanit
שָׁחֹר	shakhor
שַׁחֲרוּר	shakharur
שִׁחְרוּרוֹ	shikhruro
שְׁחַרְחַר	shkharkhar
שִׁחְרֵר	shikhrer
שֻׁחְרַר	shukhrar
שָׁט	shat
שָׁטַח	shatakh
שֶׁטַח	shetakh
שִׁטֵּחַ	shiteakh
שָׁטִיחַ אָדֹם	shatiakh adom
שָׁטַף	shataf
שִׂיחַ	siakh
שִׂיחָה	sikha
שִׁיטָה	shita
שִׁימּוּשׁ	shimush
שִׁימּוּשִׁים	shimushim
שִינְקֶן	shinken
שִׁיפוֹן	shifon
שִׁיר	shir
שִׁירוֹת	shirot
שִׁירִים	shirim
שִׁית	shit
שָׁכַב	shakhav
שְׁכוּנָה	shkhuna
שָׁכַח	shakhakh
שַׁכְחָן	shakhekhan
שַׂכִּין	sakin
שֵׂכֶל	sekhel
שִׁכְלוּל	shikhlul
שָׁכַן	shakhan
שָׁכֵן	shakhen
שִׁכְנֵעַ	shichnea
שׁ־כ־נ־ע	sh-k-n-
שֻׁכְנַע	shukhna
שְׁכֶנְתָּהּ	shchentah
שָׂכַר	sakhar
שָׂכָר	sakhar
שֶׂכֶר	sekher
שָׁכַר	shakhar
שִׁכֵּר	shiker
שַׁל	shal
שֶׁל	shel
שְׁלָבִּים	shlabim
שֶׁלֶד	sheled
שָׁלֵו	shalev
שֶׁלּוֹ	shelo
שְׂלָו	slav
שַׁלְוָה	shalva
שָׁלוֹם	shalom
שָׁלוֹם עֲלֵיכֶם	shalom aleikhem
שְׁלוֹשָׁה	shlosha
שְלוֹשָׁה עָשָׂר	shlosha asar
שְׁלוֹשִׁים	shloshim
שְׁלוֹשׁ עֶשְׂרֵה	shlosh esre
שָׁלַח	shalach
שֶׁלַח	shelach
שִׁלֵּחַ	shileach
שִׁלְחוֹ	shilcho
שֻׁלְחָן	shulchan
שֻׁלְחָן	shulkhan
שֻׁלְחָנוֹת	shulchanot
שַׁלְּחֵנִי	shalcheni
שְׁלָחַנִי	shlachani
שֻׁלְחָנִי	shulchani
שְׁלַחְתִּיךָ	shlachticha
שַׁלָּט	shalat
שִׁלְטוֹן	shilton
שִׁלְטוֹן	shilton
שַׁלָּט רָחוֹק	shalat rakhok
שֶׁלִּי	sheli
שָׁלִיחַ	shaliakh
שְׁלִיחָה	shlikha
שְׁלִילִי	shlili
שָׁלִישׁ	shalish
שְׁלִישִׁי	shlishi
שֶׁלָּךְ	shelakh
שָׁלַם	shalam
שָׁלֵם	shalem
שִׁלְּמָה	shilma
שְׁלֹמֹה	shlomo
שְׁלֵמוּת	shlemut
שֶׁלָּנוּ	shelanu
שַׁלְפּוּחִית	shalpukhit
שָׁלֹשׁ	shalosh
שְׁלֹשָׁה	shlosha
שִׁלְשׁוֹם	shilshom
שְׁלֹשֶׁת	shloshet
שָׂם	sam
שָׁם	sham
שָׁם	sham
שָׂם לֵב	sam lev
שֵׁם לְוַאי	shem levai
שֵׁם מִשְׁפָּחָה	shem mishpakha
שֵׁם עֶצֶם	shem etsem
שֵׁם פְּעֻלּה	shem-peula
שְׂמֹאל	smol
שְׂמָאלִי	smali
שָׁמוּ	shamu
שְׁמוּאֵל	shmuel
שִׁמּוּן	shimun
שֵׁמוֹת	shemot
שְׁמוֹת	shmot
שָׂמַח	samakh
שִׂמֵּחַ	simeakh
שִׂמְחָה	simkha
שְׁמִי	shmi
שְׁמִיטָה	shmita
שְׂמִיכָה	smikha
שָׁמַיִם	shamayim
שְׁמִינִי עֲצֶרֶת	shmini atseret
שְׁמִירָה	shmira
שמירטוף	shmirtuf
שְׁמִירַת	shmira
שָׂמְךָ	samcha
שְׁמֵךְ	shmech
שָׁמַן	shaman
שָׁמֵן	shamen
שִׁמֵּן	shimen
שֻׁמָּן	shuman
שְׁמַנְמַן	shmanman
שַׁמֶּנֶת	shamenet
שָׁמַע	shama
שְׁמַע	shma
שִׁמְעוֹן	shimon
שְׁמַעְיָה	shmaya
שַׁמְפַּנְיָה	shampania
שָׁמַר	shamar
שֶׁמֶר	shemer
שִׁמֵּר	shimer
שֻׁמָּר	shumar
שְׁמִרְטֵף	shmirtef
שִׁמְרִית	shimrit
שָׁמַרְנוּ	shamarnu
שָׁמַרְתְּ	shamart
שָׁמַרְתָּ	shamarta
שָׁמַרְתִּי	shamarti
שַׁמָּשׁ	shamash
שֶׁמֶשׁ	shemesh
שְׁמָשׁוֹת	shmashot
שֵׁן	shen
שָׂנֵא	sane
שִׂנְאָה	sina
שַׁנַּאי	shanai
שֹׂנְאֵינוּ	sonenu
שֵׁנָה	sheina
שִׁנָּה	shina
שֻׁנָּה	shuna
שָׂנוּא	sanu
שִׁנּוּי	shinui
שְׁנוֹרְקֶל	shnorkel
שְׁנוֹת־	shnot-
שָׁנִי	shani
שָׁנִי	shani
שֵׁנִי	sheni
שִׁנִּי	shini
שֹׁנִי	shoni
שְׁנִיָּה	shniya
שָׁנִים	shanim
שְׁנַיִם	shnayim
שְׁנֵים עָשָׂר	shneyim asar
שֵׁנִית	shenit
שִׁנְמוּךְ	shinmukh
שְׁנֵקֶל	shnekel
שְׁנַת־	shnat-
שָׁעוֹן	shaon
שָׁעוּן	shaun
שְׂעוֹרָה	seorah
שָׂעִיר	sair
שֵׂעִיר	seir
שִׁעְמוּם	shiamum
שִׁעֵר	shier
שַׂעֲרָה	saara
שערות סבתא	searot savta
שֶׁף	shef
שָׂפָה	safa
שָׂפוֹת	safot
שְׁפִיכָה	shfikha
שָׁפַךְ	shafakh
שָׂפָם	safam
שֶׁפַע	shefa
שַׁפַּעַת	shapaat
שְׂפַת־	sfat-
שְׂפָתַיִם	sfatayim
שְּׂפָתַיִם קְטַנּוֹת	sfatayim ktanot
שְׂפַת תִּכְנוּת	sfat tikhnut
ש״ץ	shats
שַׂק	sak
שָׁקַד	shakad
שָׁקֵד	shaked
שָׁקוּף	shakuf
שָׁקַט	shakat
שָׁקֵט	shaket
שֶׁקֶט	sheket
שַׂקִּים	sakim
שַׂקִּית	sakit
שָׁקַל	shakal
שֶׁקֶל	shekel
שֶׁקֶל חָדָשׁ	shekel khadash
שִׁקְמָה	shikma
שִׁקְמִים	shikmim
שֶׁקֶר	sheker
שִׁקֵּר	shiker
שִׁקְרֵי	shikrei
שַׁקְרָן	shakran
שַׁקְרָנִים	shakranim
שַׂק שֵׁנָה	sak-sheina
שַׂר	sar
שָׁר	shar
שָׁרָב	sharav
שְׁרָבִי	shravi
שָׂרָה	sara
שֵׁרוּתִים	sherutim
שָׂרֵי	sare
שִׁרְיוֹן	shiryon
שִׂרְיוֹן	siryon
שְׁרִיקַת	shrikat
שְׁרִיר	shrir
שְׁרִירֵי־	shrirei-
שְׁרִירִי	shriri
שָׂרִית	sarit
שָׂרַף	saraf
שָׂרָף	saraf
שְׂרָף	sraf
שְׂרָפִים	srafim
שָׁרַץ	sharats
שֶׁרֶץ	sherets
שָׁרַק	sharak
שֹׁרַשׁ	shorash
שֹׁרֶשׁ	shoresh
שׁ־ר־שׁ	sh-r-sh
שָׁרְשִׁי	shorshi
שָׁרְשִׁיּוּת	shorshiyut
שֳׁרָשִׁים	shorashim
שֵׁרֵת	sheret
שֵׁשׁ	shesh
שֵׁשׁ בֵּשׁ	shesh besh
שִׁשָּׁה עָשָׂר	shisha asar
שָׂשׂוֹן	sason
שִׁשִּׁים	sisim
שֵׁשׁ עֶשְׂרֵה	shesh esre
שָׁת	shat
שָׁתָה	shata
שְׁתִיָּה	shtiya
שְׁתַּיִם	shtayim
שְׁתֵּים עֶשְׂרֵה	shteyim esre
שֶׁתֶן	sheten
שׁ־ת־ן	sh-t-n
שִׁתֵּק	shiteq
שֻׁתַּק	shutaq
תָּא־גָּזִים	ta-gazim
תְּאוֹם	tom
תָּאֵי	taey
תָּאִי	tai
תָּאִים	taim
תֹּאמַר	tomar
תֹאמְרֻן	tomrun
תֵּאֵר	teer
תַּאֲרִיךְ	taarikh
תָּבֹא	tavo
תָּבֹאנָה	tavona
תֵּבָה	teva
תָּבוֹא	tavo
תְּבוּסָה	tvusa
תַּבְלִין	tavlin
תַּבְנִית	tavnit
תָּג	tag
תְּגוּבִית	tguvit
תַּגְלִית	taglit
תְּדַבֵּר	tdaber
תִּדְלֵק	tidlek
תֵּה	te
תֹּהוּ	tohu
תְּהוֹם	thom
תִּהְיֶה	tihye
תְּהִלָּה	thila
תַּהֲלִיךְ	tahalikh
תֵּה מִנְחָה	te minha
תּוֹדָה	toda
תָּוִית	tavit
תָּוִית יִדּוּעַ	tavit yidua
תָּוֶךְ	tavech
תּוֹלַעַת	tolaat
תוֹעֵבָה	toeva
תּוֹצָאָה	totsaa
תּוֹר	tor
תּוֹרָה	tora
תּוּרְכִּי	turki
תּוֹרַת־	torat-
תּוּת	tut
תְּזוּנָה	tzuna
תַּחְבּוּרָה	takhbura
תַּחְבּוּרָה צִבּוּרִית	takhbura tsiburit
תִּחוּם	tikhum
תְּחוּם	tkhum
תְּחַיּוּן	tchayun
תְּחַיֶּיןָ	tchayena
תְּחִיַּת הַמֵּתִים	tkhiyat hametim
תְּחִלָּה	thila
תָּחַם	takham
תַּחְמֹשֶׁת	takhmoshet
תַּחֲנָה	takhana
תַּחֲנַת אוֹטוֹבּוּס	takhanat otobus
תַּחְפֹּשֶׂת	takhposet
תַּחַת	takhat
תֵּיבוֹת	tevot
תִּיכוֹן	tikhon
תַּיְלַנְד	tailand
תַּיְלַנְדִּי	tailandi
תַּיְלַנְדִּית	tailandit
תַּיְלַנְדִּית	tailandit
תֵּימָן	teiman
תִּינוֹק	tinok
תִּינוֹקוֹת	tinokot
תִּינֹקֶת	tinoket
תִּיק	tik
תִּיק גַּב	tik gav
תַיָר	tayar
תִּירֶאןָ	tirena
תִּירָס	tiras
תַּכֶּה	take
תֻּכִּי	tuki
תְּכֵלֶת	tchelet
תִּכְנוּת	tikhnut
תִּכְנֵן	tikhnen
תִּכְנֵת	tikhnet
תֵּל	tel
תָּלוּי	talui
תֵּלְכוּ	telchu
תֶּלֶם	telem
תַּלְמוּד	talmud
תַּלְמִיד	talmid
תַּלְמִידָה	talmida
תְּלַת	tlat-
תַּלְתַּל	taltal
תִּלְתֵּל	tiltel
תִּלְתָּן	tiltan
תַּם	tam
תָּם	tam
תֹּם	tom
תֹּם	tom
תַּמָּה	tama
תָּמֵהַּ	tameah
תֶּמָה	tema
תֵּמַהּ	temah
תַּמּוּז	tamuz
תָּמִיד	tamid
תְּמִידִי	tmidi
תָּמִים	tamim
תְּמִימוּת	tmimut
תִּמְלָא	timla
תַּן	tan
תְּנוּחָה	tnukha
תְּנוּעָה	tnua
תנועות	tnuot
תַּנִּים	tanim
תִּנְשֶׁמֶת	tinshemet
תָּסִיל	tasil
תִּסְרֹקֶת	tisroket
תִּעֵב	tiev
תְעוּפָה	tufa
תַּעֲנִית	taanit
תַּעֲרוּכָה	taarukha
תַּעֲרוּכָה עוֹלָמִית	taarukha olamit
תַּעֲשֶׂה	taase
תַּעֲשׂוּ	taasu
תַּעֲשׂוּן	taasun
תַּפּוּז	tapuz
תַּפּוּחִים	tapukhim
תַּפּוּחֵי עֵץ	tapuche etz
תֻּפִּים	tupim
תְּפִירָה	tfira
תְּפִישָׂה	tfisa
תְּפִלָּה	tfila
תָּפַס	tafas
תַּפְקִיד	tafqid
תָּפַר	tafar
תַּפְרִיט	tafrit
תַּצְלִיל	tatzlil
תִּקְוָה	tikva
תְּקוּפוֹת	tkufot
תִּקַּח	tikach
תקטולת	tiktolet, tiqtolet
תְּקִיעָה	tkia
תַּקָּלָה	taqala
תֶּקַע	teka
תַּקְצִיב	taktsiv
תַּקְרֶאנָה	takrena
תִּקְרֶאנָה	tikrena
תַּקְרִב	takriv
תִּקְרַב	tikrav
תִּקְרָה	tikra
תִּקְשֹׁרֶת	tikshoret
תָּר	tar
תַּרְבּוּת	tarbut
תִּרְגּוּם	tirgum
תִּרְגֵּל	tirgel
תִּרְגֵּם	tirgem
תַּרְדֵּמָה	tardema
תְּרוּעָה	trua
תְּרוּפָה	trufa
תֶּרַח	terah
תְּרֵיסָר	tresar
תַּרְנְגוֹל	tarnegol
תַּרְנְגֹלֶת	tarnegolet
תַּרְנְהוֹד	tarnhod
תַּשְׁבֵּץ	tashbets
תַּשְׁדִּיר	tashdir
תַּשְׁדִּיר־שֵׁרוּת	tashdir-sherut
תְּשׂוּאָה	tsua
תְּשׂואוֹת	tsuot
תְּשׁוּבָה	tshuva
תְּשׁוּבַת־	tshuvat
תַּשְׁחֵץ	tashkhets
תְּשִׁיעִי	tshii
תַּשְׁלוּם	tashlum
תַּשְׁלִיךְ	tashlich
תַּשְׁלִיכֻהוּ	tashlichuhu
תִּשְׁעִים	tishim
תִּשְׁרֵי	tishrei
תַּתְרָן	tatran
תַּתְרָנִית	tatranit
